absolutely == adv.完全地,絕對地
abstract == adj.抽象的
n.摘要
accede to == 同意/就任
accelerate == v.加速
accept == v.接受
acceptance == n.認可,接納/接受
access == n.通路
accessible == adj.可接近的,可進入的
accommodate == v.容納
accompany == v.陪同,陪伴
accordingly == adv.因此
accountant == n.會計師
accusation == n.指控
accuser == n.原告
accustomed == adj.習慣的
across from == 在...對面
activate == v.啟動,使開始運作
address == v.稱呼
adequate == adj.合理的/足夠的/合格的/合乎需要的
adjourn == v.(使)休會/(使)休庭
adjust == v.調整,適應
adjust to == 適應
adjustment == n.調整/適應
administer == v.管理
administrator == n.行政人員
admission == n.允許/入場費,門票費/承認
admit == v.承認
adversary == n.對手,敵人
adversely == adv.不利地
advertise == v.廣告
affect == v.影響
affirm == v.確認/證實/(公開)聲明
afford == v.提供/負擔得起
agenda == n.議程
aggravate == v.使(病情)惡化, 加重/使(局勢等)更嚴重
aggress == v.侵略,攻擊
aisle == n.走道,通道,走廊
alibi == n.(尤指沒有犯罪時間的)不在犯罪現場證明
alleviate == v.減輕,緩和
alley == n.小街,小巷,小徑
allot == v.分配,分派
allow == v. 允許
along with == 除了...以外
alongside == prep./adv.在...旁邊,在...一起
alphabetical == adj.依字母順序的
alter == v.改變,更改,修改
alteration == n.變更,修改,改變
alternative route == 替代道路
ambitious == adj.有抱負的,有野心的
ambivalence == n.(心理)矛盾,猶豫不決
ample == adj.充足的
An investment destination == 投資標的,投資目的地
anniversary == n.週年紀念日
announce == v.宣布
announcement == n.公告,佈告/宣布,聲明
annoy == v.使困擾
antibiotic == n.抗生素
antique == n./adj.古董(的)/古物(的)
anxiety == n.焦慮,不安,擔心
apparent == adj.清楚明白的/明顯的
apparition == n.鬼,幽靈
appear == v.出現
applicable == adj.適用的,適合的
application == n.申請,申請書
apply == v.申請
appoint == v.任命,指派
appreciate == v.欣賞/感激/意識到,領會
approval == n.贊成,同意
arbitrator == n.裁決人,仲裁人,公斷者
arch == n.拱門/拱形
archbishop == n.大主教,樞機主教
archery == n.射箭
architect == n.建築師
arduous == adj.費力的,努力的
arena == n.(體育比賽或表演用的)場地,競技場
arrest == v.逮捕
arrive == v.到達
artist == n.藝術家
as soon as possible == 儘快=ASAP
aspect == n.方面/面貌,外表/方向,朝向
aspire to == 渴望
assembly line worker == 組裝線人員
assign == v.排定(時間或期限)
assist == v.協助,幫助
associate == v.與...有關聯
assort == v.分類
assorted == adj.綜合的,各式各樣的
assume == v.假設,假定
assumption == n.假設,推論
assurance == n.保證/自信
assure == v.保證
attach == v.附上,使附著/固定/黏貼
attack == v.攻擊,進攻
attempt == v.企圖/(尤指做難事)嘗試/(尤指為完成難事而進行的)努力
attend == v.出席,參加
attic == n.閣樓,頂樓
attract == v.吸引
auction == n./v.拍賣
auditor == n.稽核員
auto == n.汽車
adj.汽車的
autobiography == n.自傳
autograph == n.簽名,(名人的)親筆簽名
avid == adj.渴望的/熱衷的/幹勁十足的
Awards card == 集點卡,獎勵卡
aware == a.知曉的,注意到的
bachelor's degree == 學士學位
bacteria == n.細菌
bald == adj.禿頭的
banker == n.銀行家,莊家
bankruptcy == n.(企業或個人)破產
banquet == n.宴會,晚宴
bargain == n.便宜貨
barn == n.穀倉/大倉庫
barometer == n.氣壓計
basement == n.地下室
basket == n.籃子,筐子,簍子
beam == n.棟樑
bearable == adj.可忍受的,承受得起的
beard == n.鬍鬚(子)=mustache
beautician == n.美容師
beautique == n.美粧精品店
beg == v.乞求,乞討
beverage == n.飲料
beyond == prep./adv.在...那一邊,遠於/超越,超過
bicycle == n.腳踏車,自行車
bid == v.出價競標
n.出價競標的金額
bidder == n.競標者/出價最高的人
bilingual == adj.雙語的
bimonthly == adj./adv.雙月的(地) n.雙月刊
bin == n.箱子,容器,櫃
biography == n.傳記
biweekly == adj./adv.雙週的(地) n.雙週刊
blanket == n.毛毯,棉被＝quilt
blind == n.百葉窗
bookkeeper == n.簿記員,記帳員
booth == n.(市集,展覽會等處半封閉的)攤位,棚子
botanical == adj.植物(學)的
boutique == n.精品店
bow == n.船頭
box == n.(量詞)箱,盒,匣
Box office == 售票處/票房
branch == n.樹枝/分公司
breakdown == n.故障
brick == n.磚塊
bridge == n.橋
briefly == adv.短暫地
brilliant == adj.聰穎的,聰明的
broaden == v.(使)變寬/擴展
brochure == n.手冊,小冊子
broker == n.經紀人
budget == n.預算
building block == 積木
burglar == n.(入室)竊賊
buster == n.破壞的人(或物)
by a work station == 在工作站
by means of == 藉由
by the way == 順便一提=BTW
bylaw == n.地方法規, 規章制度
cab == n.計程車=taxi
cabinet == n.櫃子,櫥子
cage == n.籠子
calculate == v.計算
cameraman == n.攝影師
campaign == n.活動/競選活動
candidate == n.候選人/(職位)申請人,應徵者
capable == adj.有能力的
capacity == n.能量/容量
cape == n.斗篷,披肩,披風,圍巾
capital == n.首都/資本,資金
capitalism == n.資本主義
capitalist == n.資本主義者/資本家
capitalize == v.用大寫字母寫或印刷
captain == n.機長,艦長,船長
captivate == v.使著迷/迷住/吸引
captive == n.俘虜
care of == 由...轉交=c/o
careless == adj.不小心的,粗心的
carpenter == n.木工,木匠
carpet == n.地毯
carrier == n.運送者/航空公司
catalog == n.目錄
v.編目錄
ceiling == n.天花板
ceramic == adj.陶器的,陶瓷的
chain == n.一連串, 一系列
chairperson == n.(會議或組織的)主席,委員長,主持人=chairman
chart == n.圖表
chauffeur == n.司機=driver
chief executive officer == 執行長=CEO
childless == adj.沒小孩的
chip == n.炸洋芋片
chore == n.(家庭)雜務,日常瑣事
chronicle == v.記述/紀錄(大事)
cinema == n.電影院
circumstance == n.情況/環境
circus == n.馬戲團
circus performer == 馬戲團表演者
citizen == n.公民,市民,平民
claim == v.宣稱,主張/要求
clapperboard == n.(拍電影用的)場記板,拍板
clean-shaven == a.鬍子刮得乾淨的
clerk == n.職員,店員
client == n.客戶
closure == n.停業,倒閉,關閉
cloudless == adj.晴空的,無雲的
coeducation == n.(男女)兩性教育
coffee pot == 咖啡壶
coherent == a.相符的/連貫的
coincident == adj.巧合的
collaborate == v.合作
collapse == v./n.倒塌,崩潰
colleague == n.同事,同僚
collect == v.收集
collection == n.收集品
collector == n.收集者,收藏家
college == n. 大學,學院
collide == v.相撞,碰撞
colloquial == adj.口語的,非正式的
colon == n.冒號
colorless == adj.無色的/無趣的
combat == v.打戰
n.戰鬥,爭鬥
commencement == n.開始=begining/畢業典禮
comment == n.評論,意見
commerce == n.商業,貿易=business
commission == n.佣金
commitment == n.承諾,保證
compensate == v.補償
compensation == n.補償(金),賠償(金)
competent == adj.有能力的/能幹的/稱職的
complicated == adj.複雜的
comprehensive == adj.全面的,綜合的,詳盡的
concentrate == v.集中(注意力)
concise == adj.簡潔的
conclude == v.作結論/結束
concrete == adj.具體的,實體的 
n.水泥
condense == v.濃縮,摘要,縮短
condition == n.情況
conductor == n.指揮者/列車長/導體
confidential == adj.機密的,秘密的
confine == v.侷限,限制
confirm == v.確認
conform == v.使一致/遵守/符合
confuse == v.困惑
congratulate == v.祝賀,恭禧
congratulations == n.祝賀,恭喜
connection == n.關聯 /連接,聯繫
connections == n.(職場或選舉)人脈
conquer == v.克服/解決(問題)/戰勝
consequence == n.結果
consequently == adv.所以,因此
conservative == adj.保守的
consider == v.考慮/關心
considerably == adv.相當
consistent == adj.一致的/始終如一的
conspire == v.共謀
constant == adj.經常發生的,連續不斷的
construct == v.建造,建築
construction == n.建造,施工/建築物
construction site == 工地
construction worker == 建築工人
consultant == n.顧問,諮詢師
contact == n./v.接觸/聯繫
contagious == adj.(疾病)接觸性傳染的
contented == adj.滿足的
context == n.情境,背景,上下文
contract == n.合約,契約
contractor == n.承包商
contrast == n./v.對比
contribute == v.貢獻,捐獻(尤指錢)
contribute to == v.貢獻/捐獻(尤指錢)
controversial == adj.有爭議的,引起爭議的
convenient == adj.方便的
convention == n.大會,會議
converse == v.說話,談話
n.相反的事物
adj.相反的
conviction == n.定罪,判罪
cooperation == n.合作
corporate == adj.公司的/法人的
correct == adj.正確的
correlate == n.有相關性v.關聯
correspond == v.通信
correspondence == n.信件,通信
corruption == n.(指當權者的)腐敗,貪汙
countless == adj.無數的,數不清的
courier == n.信差,遞送員
coverage == n.保險範圍
coverage == n.範圍/新聞報導/保險(範圍)
coworker == n.同事
crate == n.木箱,貨箱
crawl == v.爬行,緩慢的移動
creativity == n.創造力
crew == n.全體工作人員
crisis == n.危機/危險期/緊要關頭
critical == adj.批評的,評論的
criticize == v.批評,評論
cuisine == n.烹飪,烹調
culinary == a.廚房的/烹調的
curb == n.(道路的)路邊
curb lane == 路肩
curtain == n.窗簾
custom == n.習俗,慣例
customize == v.訂製,客製化
data == n.資料,數據,信息
database == n.資料庫,(電腦)數據庫
deal == v.處理,協議
debate == n.討論,爭論,辯論
debt == n.債務,欠款
deck == n.甲板
decrease == v.減少
deduct == v.減去,扣除
deeply == adv.深深地,非常
defendant == n.被告
deflation == n.通貨緊縮
delectable == adj.美味的,好吃的
demolish == v.拆除,拆毀
demonstrator == n.示威者
deny == v.否定,否認/拒絕
departure == v.出發,離開
dependent == adj,依靠的,依賴的
deposite == n.存款/押金/訂金
depreciate == v.減價,貶值
deputy == n.代理人,代表
describe == v.描述,描寫
deserve == v.值得, 應得
designate == v.指定
designer == n.設計師
desire == v./n.渴望,希望,想要
despite == prep.儘管
destination == n.目的地
detach == v.分開,拆卸/使分離
detector == n.探測器,檢驗器
detour == n.繞道,繞行的路,繞行路線,改道
detour sign == 改道標誌
diagram == n.圖解,圖表
dialect == n.方言,土語,地方話
diameter == n.直徑
diaper == n.尿布
dimension == n.空間/尺寸
direct == v.引導
directly == adv.直接地
discard == v.丟棄,拋棄
disposal == n.處理,清除
disregard == n.漠視,忽視(+for)
v.忽視
distract == v.使分心
diverge == v.分岔
do judo == 柔道
do push-ups == 伏地挺身
do sit-ups == 仰臥起坐
dock == n.碼頭
dock hands == 船夫
doubt == v.懷疑
doubtless == adv.無疑地,肯定
downturn == n.(經濟)衰退,不景氣
drama queen == 喜歡小题大做的人/公主病
drastic == adj.嚴厲的,猛烈的,激烈的
drastic measures == 嚴厲的措施
drug == n.毒品
drug store == 藥局
dualism == n.二元論
dubious == adj.令人懷疑的/可疑的
duplicate == v.複製
n.複寫紙
duty == n.義務,職責/關稅
eager == adj.熱切的,渴望的
ecocide == n.破壞生態,生態滅絕
election == n.選舉
elective == adj.選舉的,由選舉産生的,有選擇的
electrician == n.電工,電氣技師
emit == v.散發(出來)
emphasis == n.強調
employ == v.僱用
employee == n.員工
employment == n.雇用,就業
enclose == v.隨信(或包裹)附上/把...圍起來,圍住
enclosed == adj.隨函附上的,附上的
endeavor == v./n.努力
energetic == adj.精力充沛的,有活力的
engineer == n.工程師
enrollment == n.登記/註冊
entertain == v.接待,招待
environmental == adj環境的
era == n.時代,年代
erode == v.侵蝕,腐蝕
escape == n./v.逃跑,逃脫
essential == adj.必要的
estimate == n.估價(單)
ethnic == adj.種族的,民族的
etiquette == n.禮儀
evacuation == n.疏散,撤離
eventual == adj.最終的,最後的
excavate == v.挖掘
excavation == n.挖掘
exceed == v.超過
exception == n.例外
exclusive == adj.獨有的,獨佔的
excuse == v.原諒,寬恕
executive == n.高階主管=chief
executive officer == 執行長
exhaust == n.排氣管
v.使筋疲力竭,使疲憊不堪
exhibit == v.展出
n.陳列品
exhibition == n.(大型、綜合)展覽會
exist == v.存在
exotic == adj.異國的,外來的/奇異的
expect == v.預料,預期
expectation == n.期待
expire == v.到期,結束/死亡
expose == v.使暴露,受到
exterior == adj.外部的,外面的
extraordinary == adj.非凡的,令人驚奇的
extremely == adv.非常
eyewitness == n.目擊證人
fabric == n.布料
fabulous == adj.極好的,相當好的
facilities == 設施
facility == n.場所/facilities設施
factory == n.工廠
family gathering == 家庭聚會
fancy == adj.高級的,華麗的
fare == n.(交通工具的)票價,車(船)費=fee
farewell == n.告別
fast-paced == 快速進行的
fasten == v.繫緊,固定
feature == n.特徵,特色
federal == adj.聯邦(制)的,聯邦政府的
field == n.田野/(通常有草坪的)運動場
figure == n.數字,數量/身材=body
figure out == 弄清楚/理解
file == v.歸檔
file clerk == 檔案員
finance == v.提供資金,資金支援
firm == n.公司
flash-frozen == 急速冷凍
flavor == n.口味,味道
floor lamp == n.落地燈
fold == v.折疊,對折(指紙或布)/可折疊
force == n.力量/暴力,武力
forceful == adj.強力的
forecast == n./v.預測
forefather == n.祖先
foreman == n.領班,工頭
form == n.類型,種類
fortune == n.財產,財富
forward == v.轉寄,傳遞
fragile == adj.易損壞的
frame == n.(圖畫、門、窗的)框,框架
framework == n.結構,體制
franchise == n.特許經營權
fraud == n.詐騙(罪),詐欺
frequently asked question == 常見問題,常問問題=FAQ
fuel == n.燃料
fulfill == v.履行/完成/達到(目的)
function == n.功能,用途
fund == n.資金,基金
furnish == v.裝潢,佈置(傢俱)
futures == n.期貨
gadget == n.小器具
gain == v.獲得
gallery == n.藝廊,畫廊
gather == v.聚集
generate == v.造成,發生
girder == n.大樑
gradually == adv.逐漸地
grand == adj.雄偉的,壯麗的/主要的,首要的
grant == v.同意,允許/給予
graph == n.圖表,長條圖=chart
grateful == adj.感激的,感謝的
gratefully == adv.感激地
grievance == n.不滿,抱怨,委屈
guarantee == n.保證(書),擔保
guide == n.手冊,指南/旅行指南
haircutter == n.理髮師
hairstylist == n.髮型設計師
hallway == n.玄關/走廊
halt == v.停止,中斷
hammer == n 鐵鎚
hand == v.交給
handicap == n.殘障,殘疾
handicraft == n.手工藝品
handkerchief == n.手帕
handyman == n.工人,雜工,修理匠
hard hat == 工地安全帽
hare == n.野兔
harsh == adj.嚴厲的,嚴酷的
head over heels == 墜入愛河head over heels (in love)
heat == n.供暖系統,暖氣設備
hectic == adj.忙亂的,繁忙的
helmet == n安全帽
hesitate == v.猶豫,躊躇
hindrance == n.阻礙,障礙
hold == v.容納
homeless == adj.無家可歸的
n.流浪漢
homeowner == n.屋主
hopeless == adj.沒希望的
horrible == adj.極糟的,恐怖的
housekeeper == n.管家,房務員
hybrid == n.油電混合車
icon == n.偶像/圖像/圖示
immigrant == n.移民
impact == n.影響,作用/衝擊(力)
impede == v.妨礙,阻礙
impose == v.強制實行,推行
in a hallway == 在走廊上
in charge of == 負責=be responsible for
in exchange for == 以交換......
in favor of == 有利於
in spite of == 儘管=regardless of
inadequate == adj.(數量)不充足的/不夠好的,劣質的
incentive == n.獎勵,鼓勵
inclement == adj.天氣險惡的,氣候嚴酷的
incorporate == v.包含
increase == v.增加
indeed == adv.確實,的確
indication == n.徵兆,象徵
industry == n.工業,產業
infant == n.嬰兒
infatuated == adj.(通常短期)熱戀的,著迷的
inference == n.推理,推論,推斷,推測
Inflate == v.使充氣,使膨脹
inflation == n.通貨膨脹
informal == adj.非正式的
informative == adj.提供資訊的/見識廣博的,有益處的
initial == adj.最初的,開始的
initially == adv.起初,最初,一開始
initiative == n.主動,主導權
injure == v.受傷,損害
inquire == v.打聽,詢問
inquiry == n.詢問,打聽
insist == v.堅持
inspect == v.檢查
inspection == n.檢查,檢驗
inspector == n.檢查員,視察員,督察員
installment == n.分期付款
institute == n.研究所,學院
instructions == n.使用說明,操作指南
insurance == n.保險
integral == a. 構成整體所必需的
intellect == n.才智,智力
intellectual == adj.智力的
n.知識分子
intention == n.企圖,打算
interior == n.內部
intersection == n.交叉路口,十字路口/(兩條線的)相交,交點
interviewee == n 接受面試者,接受採訪者,被訊問者
intrude == v.入侵,闖進/打擾
inventory == n.存貨清單,庫存
invest == v.投資,投入
investigate == v.調查,審查
invitation == n.邀請(卡)
invoice == n.發票,發貨單
involvement == n.參與/涉入,介入
issue == n. 發行刊物,期刊
jealous == adj.忌妒的
jet lag == 時差
jewel == n.珠寶,寶石
jewelry == n.(總稱)珠寶,首飾
job == n.工作,職業=occupation
journal == n.雜誌,期刊
journalism == n.新聞業,報章雜誌業
journalist == n.新聞工作者
judge == v.(尤指認真考慮之後)斷定,判斷,估計
n.法官/(比賽的)裁判員
Keynote address == 主題演說,專題演講
kiosk == n.(售糖果、飲料、報紙等的)亭子
kisses and hugs == 接吻與擁抱=XO
kitchenware == n.廚房用具
labor == n.勞動,勞工
labor and parts == 人力及零件
laboratory technician == 實驗室技術人員
lack == v./n.缺少,缺乏
lamb == n.羊肉
landlord == n.房東/地主
landscape == n.風景(畫)
v.造景
lane == n.小巷/車道/航道/跑道
lately == adv.最近
lawn == n.草地,草坪
lawyer == n.律師
layoff == n.解雇,裁員
lead == v.領導,帶領
leak == n.(水,瓦斯等的)漏出/漏洞
lean against == 倚靠
lease == n.租約,契約,租賃契約
v.租借,租用
lecture == n.演講,(尤指面向學生的)講座,課
length == n.長度
lent == v.借給,借出
librarian == n.圖書館員
license == n.執照,許可證
lid == n.蓋子
lie == n.位於,坐落在
lighting technician == n.燈光師
likewise == adv. 同樣地
line == n.(商品)種類
loop == n.圓圈,環形
lot == n.一塊地,場地
lounge == n.休息室
loyal == adj.忠誠的
luggage == n.行李
lying == v.躺,平躺
madam == n.(對婦女的恭敬稱呼)女士,夫人,太太
magician == n.魔術師
make-up artist == n.化妝師
manipulate == v.操縱,操作
manner == n.方式,方法
manual == n.使用手冊,說明書
manufacturer == n.製造商
manuscript == n.手稿,原稿
marker == n.白板筆,記號筆
marvellous == adj.絕妙的,極好的
maternity == adj.懷孕的,產婦的
meanwhile == adv.(與其)同時,在此期間
measure == v.測量/衡量
memorandum == n.備忘錄,便箋
merchant == n.商人,(尤指外貿)批發商
merge == v.(商場)合併,併購
merit == n.功勞,功績/價值/好處,優點
metal worker == n.焊接工人,金屬工人
meter == n.公尺
v.測量,計量
metropolitan == adj.大都市的
mill == n.製造廠,工廠
minutes == n.會議記錄
miscellaneous == adj.混雜的,各種各樣的
misfortune == n.不幸,災禍
misrepresent == v.誤傳
missionary == n.傳教士
model == n.型號,款式
modify == v.修改,修正
mogul == n.大人物,重要人物
monologue == n.獨白,(一個人)滔滔不絕地說話
monopolize == v.壟斷，獨佔
monopoly == n.壟斷、獨占
moreover == adv.而且,此外
mortgage == n./v.抵押
mortician == n.殯葬業者,禮儀師
multiple == adj.多個的/多種的
n.倍數
musician == n.音樂家
nail == n.釘子/指甲
napkin == n.餐巾(紙)
nasty == adj.人討厭的/不友善的,惡意的
negate == v.否定, 取消
neglect == v./v.忽視,疏忽,忘記
negotiator == n.談判者,談判專家
Never put off what you can do today until tomorrow. == 今日事,今日畢
newsletter == n.(機構定期寄發給成員的)通訊,簡報
newsstand == n.書報攤
niche == n.合適的工作或活動,合適的位置
niece == n.侄女,外甥女
normally == adv.正常,通常
northbound == adj./adv.向北(的),北行(地)
novice == n.新手,初學者
numerically == adv.數字地
object == v.反對
objective == n.目標
adj.客觀的
observe == v.觀察/遵守
observer == n.觀察員,觀察家
obsessed == adj.著迷的,困擾的,心神不寧的
obstacle == n.障礙,阻礙,妨礙
obtain == v.得到,獲得
occasion == n.(尤指某事發生的)時刻/場合,盛會
occupancy == n.居住/佔用
occupant == n.居住者/佔有人,佔用者
occupation == n.工作,職業
odd == adj.不常發生的/奇特的,古怪的
off-limits == 禁止進入的,禁止入內的
omission == n.遺漏,疏忽
on the job == 在職場上
ongoing == adj.進行中的,持續存在的
operate == v.操作,使用/運轉,運作/營運
operator == n.操作人員/接線員
opinion == n.意見,看法
opponent == n.對手;敵手,反對者
opposite == adj.全然不同的/相反的,對立的
prep.在...對面
opposite one another == 倆倆相對
optimistic == adj.樂觀的
option == n.選擇
oral == adj.口頭的,口述的
n.口試
oral presentation == 口頭發表
order == n.秩序
ordinary == adj.普通的,平常的,一般的,平凡的
orientation == n.定向,目標/方向/新生訓練
outbuilding == n.附屬建築物
overactive == adj.過動的,過度活躍的
overall == adj./adv.整體來說
overcharge == v.超收費用/過度充電
overcome == v.克服/戰勝
overdue == adj.逾期的
overestimate == v.高估,評價過高
overhang == n.突出物
overhear == v.無意間聽到
overlook == v.忽視,忽略/眺望
overpass == n.天橋,高架
overrule == v.駁回,否决
overthrow == v.顛覆,推翻/投(球)過猛
overtime == adv.超時,加班
pace == n.(移動的)步調/(發生的)速度,節奏
parallel == adj.平行的/相同的,類似的
participant == n.參加者,參與者
particularly == adv.尤其,特別地=especially
partition == n.隔開,隔牆
patent == n.專利(權)
pattern == n.模式,方式,形式
pavement == n.人行道=sidewalk
paycheck == n.薪水,工資
payment == n.付款,支付(的款項)
payroll == n.薪水帳冊,發薪名單
payroll office == 出納室,工資辦公室
pedestal == n.基座,底座
pedestrian crossing == 斑馬線,行人穿越道
pedestrian overpass == (行人專用)天橋
percentage == n.百分比,百分率
perhaps == adv.或許,可能
perimeter == n.(圓)周長/周邊,邊緣
period == n.期間
permit == v.允許
n.許可證,執照
pesticide == n. 殺蟲劑,農藥
pharmacist == n. 藥劑師
phase == n.時期,階段
v.逐步進行
photograph == n.照片,相片
v.照相,攝影
photographer == n.攝影師/照相師
photography == n.攝影
picket == n.糾察隊/示威遊行
pickup == n.恢復景氣,好轉/增加,提高
pile == n.一堆,疊
pillow == n.枕頭
pilot == n.飛行員
pipe == n.管子,(水)管
pitcher == n.大水壺/(棒球)投手
place setting == 一套餐具,擺設
plaintiff == n.原告
plant == n.植物/機器,設備,工廠
plate == n.盤子/碟
playhouse == n.劇場,劇院
pleasant == adj.令人愉快的,宜人的,親切友好的
please == 請=PLS
plumber == n.水管工人,水電工
plywood == n.夾板,合板
polite == adj.有禮貌的
political opponent == 政敵
porch == n.門廊,玄關
porter == n.行李員,門房=doorman
portrait == n.肖像(畫)
possible == adj.可能的
postgraduate == n.研究生
postpone == v.延期
postscript == n.附記,(正文後的)附言,補充說明=PS
postwar == adj. 戰後的
pot == n.盆,罐,壺/一罐(一壺,一瓶等)的量
potential == adj.潛在的
potentially == adv.可能地,潛在地
practice == n.習慣,慣例/習俗/練習,訓練
prearrange == v.預先安排
precaution == n.預防(措施)
precise == adj.精確的/準確的,確切的
preclude == v.(事先)排除/防止/阻止
prediction == n.預計,預測
prejudice == n. 偏見,成見,歧視
v. 使產生偏見
premature == adj. 過早的,早產的/不成熟的/倉促的
premises == n.營業場所
prescribe == v.開處方,開藥方
presentation == n.演講,簡報
preservation == n.保護,保養,保藏
pressure == n.壓力
prevail == v.佔優勢,占上風/勝過,勝出
previously == adv.先前地,以前地
priority == n.優先考慮的事/優先權
private == adj.私人的,私有的/不公開的
probation == n.(法律)緩刑,假釋/(公司)見習,實習
proceed == v.繼續進行/著手
productive == adj.多產的,增加產量的
profession == n.職業=occupation=job
professor == n.教授
proficient == adj.精通的,熟練的
program == n.節目(單)/計畫/程式
prohibit == v.禁止,防止,阻止
projector == n.投影機
prompt == adj.迅速的
pronunciation == n.發音
property == n.財產,資產/(拍電影用的)道具
proposal == n.提案
propose == v.計劃,建議
prosecutor == n.檢察官
protest == n.抗議,反對
protester == n.抗議者
provider == n.提供者,供應商
proximity == n.鄰近,接近
psychologist == n.心理學家
publish == v.出版,刊登
pull == v.拉,拖
punctual == adj準時的,守時的
pursu == v.追求
push in == 推入
qualification == n.資格,條件
quantity == n.量,數量
question and answer == 問與答=Q & A
quilt == n.棉被
quota == n.(商品)配額,定額,限額
quote == v.引用/舉出
railing == n.(通常指金屬或木頭的)欄杆
ranch == n.大牧場,大農場
random == adj.胡亂的
reach == v.到達/達到/伸手拿
n.伸手可及的距離
readjust == v.重新調整,微調
realtor == n.房地産代理,房屋仲介
rear == adj.後面的,背後的=back
recall == v.召回,回收
receive == v.收到,接到
reception == n.歡迎會/接待(處)
reconfirm == v.再確認,再證實
recruit == v.招募
reference == n.推薦信,介紹信/參考
refill == n./v.再次填充滿...的量,續杯
refinery == n.精煉廠,提煉廠
refuse == v. 拒絕
regarding == prep.關於,至於
regardless of == 儘管=in spite of
register == v.登記,註冊
registration == n.登記/註冊/掛號
regret == v.懊悔/抱歉/遺憾
regulatory == adj.管理的
rehearse == v.排練,預演
reimburse == v.償還,補償
reimbursement == n.費用核銷
relation == n.關係
relatively == adv.相對地
reliability == n.可靠性,可依賴性
relieve == v.減輕
relinquish == v.放棄(權力、地位),辭去
relocate == v.重新安置,(使)搬遷
rely == v.依靠
remodel == v.重新塑造,重建
removal == n.移動,除去
remove == v.排除,移除
renovate == v.修復,裝修,翻新(尤指舊建築)
rent == n.租金,房租
v.租用,租出
rental == n.出租,租金
repair personnel == 維修人員,修理(護)人員
replaceable == adj.可替換的
reported == adj.據報告的/據報導的/據傳聞的
represent == v.代表=stands for/提出,表達
representative == n.代表,代理人
request == v./n.(正式的)要求,請求
residence == n.住所,住宅
resign == v.辭職
resistance == n.抵抗
resort == n.度假勝地
respond == v. 回答,回應
response == n. 回答,回應
responsible for == 負責=in charge of
retailer == n.零售商
retain == v.保留,維持
retrieve == v.找回,重新得到
reverse == n.相反
revise == v.修改,修正
revision == n.修正,修改
risk == n.危險,風險
road closure == 道路封閉
roast == v.烤/烘
roof == n,屋頂/車頂
route == n.路線
rug == n.毯子/地毯
rule out == 排除
rural == adj.鄉村的,農村的/似鄉村的
sail == v.(船)航行
n.帆
sailor == n.海員,水手
salesperson == n. 售貨員,推銷員,店員
salon == n.美容院/會客室
satisfied == adj.感到滿意的
satisfy == v.使滿意,使滿足
sauce == n.調味醬,醬料
saucer == n.茶碟,茶託
savory == adj.風味極佳的,可口的,味美的
scholarship == n.獎學金
scientific == adj.科學的
scientist == n.科學家
screen == n.投影幕,螢幕
sculpture == n.雕刻(作品)
seal == n.封口/印章/封條
season == v.調味,醬料
secretary == n. 秘書(複數secretaries)
secure == v.獲得
security guard == 警衛,保全人員
semidiameter == n.半徑
seminar == n.研討會
seminar == n.研討會
senior == adj.級別高的
set == n.(拍電影用的)佈景
set for == 擺設/設置
setback == n.障礙/挫折
shareholder == n.股東
shed == n.(通常爲木質,存放物品用的)棚子,小屋,倉庫
sheet == n.床單
shelf == n.架子
shipment == n.運輸
shipping agent == 海運代理商,快遞代理商
shortfall == n.不足,差額
side by side == 並排
sidewalk == n.人行道=pavement
simplify == v.簡化
skeptical == adj.懷疑性的
slender == adj.苗條的,纖細的
snail == n.蝸牛
snare == n.陷井,羅網
solar == adj.太陽的
sore == v.擦傷
specific == adj.特定的,特有的
specification == n.說明書
specify == v.具體指出,詳細說明
spot == n.地點,場所
square == n.正方形/廣場
stadium == n.體育場
stairway == n.樓梯
stand == n.架子
stand-in == n.替身(演員)
startup == n.啟動,發動
statistics == n.統計學
statue == n.雕像
status == n.狀態/地位
steel == n.鋼鐵
still life == 靜物(畫)
stockbroker == n.股票(或證劵)經紀人(經紀公司)
stool == n.凳子,板凳
storage == n.儲存,儲藏,儲備/儲藏室
story == n.樓層(量詞)
stove == n.爐,瓦斯爐
stow == v.貯藏
stranger == n.陌生人/外地人
strategic == adj.戰略(性)的,策略(上)的
street vendor == 街頭小販,路邊攤販
streetlamp == n.街燈,路燈=streetlight
strengthen == v.加強,增強
strenuous == adj.費力的/耗費精力的
strike == v.罷工
stroke == n.中風
submarine == n.潛水艇
submerge == v.浸沒, 淹沒,使潛入水中
submit == v. 提交,
subnormal == adj.低能的,低於正常標準的
subscribe == v.訂閱(購)
substantial == adj.大量的
substantiate == v.證實,具體化
substitute == v.用...代替
substitute for == 代替,取代
subtract == v.減去,減
suburb == n.郊區,市郊住宅區
suffer == v.經歷/受折磨,受苦/遭受
suicide == n.自殺(者)
suit == n.套裝
suitcase == n.手提箱
superficial == adj.表面的/(人)膚淺的, 淺薄的
superintendent == n.(大樓的)看管人/主管,負責人
superman == n.超人
superpower == n.超級大國
superstitious == adj.迷信的
supervisor == n.監督者,管理人,指導者
surgery == n.(外科)手術
survive == v.存活,生存
suspicious == adj.可疑的
sustainable == adj.可持續的,能維持的
tablecloth == n.桌布,枱布
tailor == n.裁縫師
tailor-made == adj.特製的,訂做的
take off == 脫掉/起飛
tank == n.(盛放液體或氣體的)容器/坦克
tariff == n.關稅
tear == v.(被)撕開,(被)撕掉
tear\tore\torn
technical == adj.技術的/專門性的
technician == n.技術人員,技師
telegram == n.電報=telegraph
telegraph == n.電報=telegram
telephone pole == 電線杆
teller == n.(銀行)出納員
temporary == adj.暫時的,短暫的
tenant == n.承租人,房客
terminal == n.(機場)航廈
terms == n.條款
terrible == adj.可怕的
terrorist == n.恐怖分子
testimony == n.(尤指法庭上的)證詞
thermometer == n.溫度計
thoroughly == adv.非常/徹底地
thoughtful == adj.體貼的
thoughtfully == adv.體貼地
throughout == adv./prep.遍及
tire == n.輪胎
to one side of == 在...的旁邊
tone == n.(常指對聽話人的)語氣,腔調,口吻
toner == n.碳粉(the boxes of the toner)
tour == n.(工廠、設施等的)參觀/短期旅行
tower == n.塔,高樓
trade == n.貿易,交易,生意
trading == n.交易
traffic light == 紅綠燈
traffic sign == 交通號誌
transaction == n.交易
transcribe == v.紀錄/轉寫
transcription == n.記錄/抄寫
transform == v.變形
transfuse == v.滲透/輸血
transmit == v.發射,傳送(信號)/傳遞,傳播
transport == n.(交通)運輸,運送,輸送/交通工具
trap == n.陷阱
trauma == n.精神創傷,心理創傷/外傷
tree branch == 樹幹
trend == n.趨勢,傾向/時尚
trilateral == adj.對三方有關係的
trim == v.修剪/整理
trolley == n.手推車/有軌電車
troubleshoot == v.疑難排解
tuition == n.學費
turn away == 轉過去/逃避
turn down == 拒絕
turn in == 繳交=submit
turn on == 打開,開啟
turn up == 出現=appear
twig == n.細枝,嫩枝
unanimous == adj.全體一致的
unanimously == adv.全體一致地
underestimate == v.低估,估計不足/看清
underpass == n.地下道
unfurnished == adj.沒有傢俱的
unicorn == n.獨角獸
uniform == n.制服
unify == v.統一/一致
union == n.工會
unique == adj.獨一無二的
unite == v.統一/整合
universal == adj.宇宙的/普遍的
university == n.大學
unmade == adj.(床鋪)未整理的
unpleasant == adj.令人不愉快的
unproven == adj.未經證實的
urban == adj.都市的,居住在城市的
urban area == 市區
useless == adj.無用的,無效的
utility == n.(電、煤氣、鐵路等)公共設施,公共事業/實用性
vacate == v.騰出,空出,離開
vaild == adj.有效的
valid == adj.(票或其他)正式認可的/有法律效力的
van == n.廂型車,麵包車
variant == adj.有差異的,不同的
n.變形,變化
variation == n.變化
variety == n.多樣性,多樣化
various == adj.不同的,各式各樣的
vehicle == n.車輛,(陸上)交通工具
vendor == n.小販,賣主
versatile == adj.多才多藝的
version == n.版本
victim == n.受害者,罹難者
violation == n.違反/侵犯
virus == n.病毒
visible == adj.可看見的
vital == adj.極其重要的
volunteer == n.志願者,志工
vote == v.選舉,投票,表決
voucher == n.折價券,現金卷,票券
wagon == n.四輪運貨馬車
waive == v.放棄(權利)/不遵守(規則)
walkway == n.(尤指有篷或高架的)走道,人行道
warrant == n.逮捕令
warrenty == n.保證書,保卡
whenever == adv./prep.無論何時
whiteboard == n.白板
wide == adj.寬的
wildly == adv.失去控制地
wire == n.電線/金屬線
withdraw == v.撤回,撤離
within == prep.在...之內
witness == n.目擊者
worker == n.工人/工作者
workman == n.工人,工匠
workmanlike == adj.做工精細的,技術純熟的
workmanship == n.手藝,做工
worth == adj值得的
wrap == v.包裝/用...包裹

absolutely==adv.完全地,絕對地
abstract==adj.抽象的
n.摘要
accede to==同意/就任
accelerate==v.加速
accept==v.接受
acceptance==n.認可,接納/接受
access==n.通路
accessible==adj.可接近的,可進入的
accommodate==v.容納
accompany==v.陪同,陪伴
accordingly==adv.因此
accountant==n.會計師
accusation==n.指控
accuser==n.原告
accustomed==adj.習慣的
across from==在...對面
activate==v.啟動,使開始運作
address==v.稱呼
adequate==adj.合理的/足夠的/合格的/合乎需要的
adjourn==v.(使)休會/(使)休庭
adjust to==適應
adjust==v.調整,適應
adjustment==n.調整/適應
administer==v.管理
administrator==n.行政人員
admission==n.允許/入場費,門票費/承認
admit==v.承認
adversary==n.對手,敵人
adversely==adv.不利地
advertise==v.廣告
affect==v.影響
affirm==v.確認/證實/(公開)聲明
afford==v.提供/負擔得起
agenda==n.議程
aggravate==v.使(病情)惡化, 加重/使(局勢等)更嚴重
aggress==v.侵略,攻擊
aisle==n.走道,通道,走廊
alibi==n.(尤指沒有犯罪時間的)不在犯罪現場證明
alleviate==v.減輕,緩和
alley==n.小街,小巷,小徑
allot==v.分配,分派
allow==v. 允許
along with==除了...以外
alongside==prep./adv.在...旁邊,在...一起
alphabetical==adj.依字母順序的
alter==v.改變,更改,修改
alteration==n.變更,修改,改變
alternative route==替代道路
ambitious==adj.有抱負的,有野心的
ambivalence==n.(心理)矛盾,猶豫不決
ample==adj.充足的
An investment destination==投資標的,投資目的地
anniversary==n.週年紀念日
announce==v.宣布
announcement==n.公告,佈告/宣布,聲明
annoy==v.使困擾
antibiotic==n.抗生素
antique==n./adj.古董(的)/古物(的)
anxiety==n.焦慮,不安,擔心
apparent==adj.清楚明白的/明顯的
apparition==n.鬼,幽靈
appear==v.出現
applicable==adj.適用的,適合的
application==n.申請,申請書
apply==v.申請
appoint==v.任命,指派
appreciate==v.欣賞/感激/意識到,領會
approval==n.贊成,同意
arbitrator==n.裁決人,仲裁人,公斷者
arch==n.拱門/拱形
archbishop==n.大主教,樞機主教
archery==n.射箭
architect==n.建築師
arduous==adj.費力的,努力的
arena==n.(體育比賽或表演用的)場地,競技場
arrest==v.逮捕
arrive==v.到達
artist==n.藝術家
as soon as possible==儘快=ASAP
aspect==n.方面/面貌,外表/方向,朝向
aspire to==渴望
assembly line worker==組裝線人員
assign==v.排定(時間或期限)
assist==v.協助,幫助
associate==v.與...有關聯
n.朋友/同事,(生意)夥伴
assort==v.分類
assorted==adj.綜合的,各式各樣的
assume==v.假設,假定
assumption==n.假設,推論
assurance==n.保證/自信
assure==v.保證
attach==v.附上,使附著/固定/黏貼
attack==v.攻擊,進攻
attempt==v.企圖/(尤指做難事)嘗試/(尤指為完成難事而進行的)努力
attend==v.出席,參加
attic==n.閣樓,頂樓
attract==v.吸引
auction==n./v.拍賣
auditor==n.稽核員
auto==n.汽車
adj.汽車的
autobiography==n.自傳
autograph==n.簽名,(名人的)親筆簽名
avid==adj.渴望的/熱衷的/幹勁十足的
Awards card==集點卡,獎勵卡
aware==a.知曉的,注意到的
bachelor's degree==學士學位
bacteria==n.細菌
bald==adj.禿頭的
banker==n.銀行家,莊家
bankruptcy==n.(企業或個人)破產
banquet==n.宴會,晚宴
bargain==n.便宜貨
barn==n.穀倉/大倉庫
barometer==n.氣壓計
basement==n.地下室
basket==n.籃子,筐子,簍子
beam==n.棟樑
bearable==adj.可忍受的,承受得起的
beard==n.鬍鬚(子)=mustache
beautician==n.美容師
beautique==n.美粧精品店
beg==v.乞求,乞討
beverage==n.飲料
beyond==prep./adv.在...那一邊,遠於/超越,超過
bicycle==n.腳踏車,自行車
bid==v.出價競標
n.出價競標的金額
bidder==n.競標者/出價最高的人
bilingual==adj.雙語的
bimonthly==adj./adv.雙月的(地) n.雙月刊
bin==n.箱子,容器,櫃
biography==n.傳記
biweekly==adj./adv.雙週的(地) n.雙週刊
blanket==n.毛毯,棉被＝quilt
blind==n.百葉窗
bookkeeper==n.簿記員,記帳員
booth==n.(市集,展覽會等處半封閉的)攤位,棚子
botanical==adj.植物(學)的
boutique==n.精品店
bow==n.船頭
Box office==售票處/票房
box==n.(量詞)箱,盒,匣
branch==n.樹枝/分公司
breakdown==n.故障
brick==n.磚塊
bridge==n.橋
briefly==adv.短暫地
brilliant==adj.聰穎的,聰明的
broaden==v.(使)變寬/擴展
brochure==n.手冊,小冊子
broker==n.經紀人
budget==n.預算
building block==積木
burglar==n.(入室)竊賊
buster==n.破壞的人(或物)
by a work station==在工作站
by means of==藉由
by the way==順便一提=BTW
bylaw==n.地方法規, 規章制度
cab==n.計程車=taxi
cabinet==n.櫃子,櫥子
cage==n.籠子
calculate==v.計算
cameraman==n.攝影師
campaign==n.活動/競選活動
candidate==n.候選人/(職位)申請人,應徵者
capable==adj.有能力的
capacity==n.能量/容量
cape==n.斗篷,披肩,披風,圍巾
capital==n.首都/資本,資金
capitalism==n.資本主義
capitalist==n.資本主義者/資本家
capitalize==v.用大寫字母寫或印刷
captain==n.機長,艦長,船長
captivate==v.使著迷/迷住/吸引
captive==n.俘虜
care of==由...轉交=c/o
careless==adj.不小心的,粗心的
carpenter==n.木工,木匠
carpet==n.地毯
carrier==n.運送者/航空公司
catalog==n.目錄
v.編目錄
ceiling==n.天花板
ceramic==adj.陶器的,陶瓷的
chain==n.一連串, 一系列
chairperson==n.(會議或組織的)主席,委員長,主持人=chairman
chart==n.圖表
chauffeur==n.司機=driver
chief executive officer==執行長=CEO
childless==adj.沒小孩的
chip==n.炸洋芋片
chore==n.(家庭)雜務,日常瑣事
chronicle==v.記述/紀錄(大事)
cinema==n.電影院
circumstance==n.情況/環境
circus performer==馬戲團表演者
circus==n.馬戲團
citizen==n.公民,市民,平民
claim==v.宣稱,主張/要求
clapperboard==n.(拍電影用的)場記板,拍板
clean-shaven==a.鬍子刮得乾淨的
clerk==n.職員,店員
client==n.客戶
closure==n.停業,倒閉,關閉
cloudless==adj.晴空的,無雲的
coeducation==n.(男女)兩性教育
coffee pot==咖啡壶
coherent==a.相符的/連貫的
coincident==adj.巧合的
collaborate==v.合作
collapse==v./n.倒塌,崩潰
colleague==n.同事,同僚
collect==v.收集
collection==n.收集品
collector==n.收集者,收藏家
college==n. 大學,學院
collide==v.相撞,碰撞
colloquial==adj.口語的,非正式的
colon==n.冒號
colorless==adj.無色的/無趣的
combat==v.打戰
n.戰鬥,爭鬥
commencement==n.開始=begining/畢業典禮
comment==n.評論,意見
commerce==n.商業,貿易=business
commission==n.佣金
commitment==n.承諾,保證
compensate==v.補償
compensation==n.補償(金),賠償(金)
competent==adj.有能力的/能幹的/稱職的
complicated==adj.複雜的
comprehensive==adj.全面的,綜合的,詳盡的
concentrate==v.集中(注意力)
concise==adj.簡潔的
conclude==v.作結論/結束
concrete==adj.具體的,實體的 
n.水泥
condense==v.濃縮,摘要,縮短
condition==n.情況
conductor==n.指揮者/列車長/導體
confidential==adj.機密的,秘密的
confine==v.侷限,限制
confirm==v.確認
conform==v.使一致/遵守/符合
confuse==v.困惑
congratulate==v.祝賀,恭禧
congratulations==n.祝賀,恭喜
connection==n.關聯 /連接,聯繫
connections==n.(職場或選舉)人脈
conquer==v.克服/解決(問題)/戰勝
consequence==n.結果
consequently==adv.所以,因此
conservative==adj.保守的
consider==v.考慮/關心
considerably==adv.相當
consistent==adj.一致的/始終如一的
conspire==v.共謀
constant==adj.經常發生的,連續不斷的
construct==v.建造,建築
construction site==工地
construction worker==建築工人
construction==n.建造,施工/建築物
consultant==n.顧問,諮詢師
contact==n./v.接觸/聯繫
contagious==adj.(疾病)接觸性傳染的
contented==adj.滿足的
context==n.情境,背景,上下文
contract==n.合約,契約
contractor==n.承包商
contrast==n./v.對比
contribute to==v.貢獻/捐獻(尤指錢)
contribute==v.貢獻,捐獻(尤指錢)
controversial==adj.有爭議的,引起爭議的
convenient==adj.方便的
convention==n.大會,會議
converse==v.說話,談話
n.相反的事物
adj.相反的
conviction==n.定罪,判罪
cooperation==n.合作
corporate==adj.公司的/法人的
correct==adj.正確的
correlate==n.有相關性v.關聯
correspond==v.通信
correspondence==n.信件,通信
corruption==n.(指當權者的)腐敗,貪汙
countless==adj.無數的,數不清的
courier==n.信差,遞送員
coverage==n.保險範圍
coverage==n.範圍/新聞報導/保險(範圍)
coworker==n.同事
crate==n.木箱,貨箱
crawl==v.爬行,緩慢的移動
creativity==n.創造力
crew==n.全體工作人員
crisis==n.危機/危險期/緊要關頭
critical==adj.批評的,評論的
criticize==v.批評,評論
cuisine==n.烹飪,烹調
culinary==a.廚房的/烹調的
curb lane==路肩
curb==n.(道路的)路邊
curtain==n.窗簾
custom==n.習俗,慣例
customize==v.訂製,客製化
data==n.資料,數據,信息
database==n.資料庫,(電腦)數據庫
deal==v.處理,協議
debate==n.討論,爭論,辯論
debt==n.債務,欠款
deck==n.甲板
decrease==v.減少
deduct==v.減去,扣除
deeply==adv.深深地,非常
defendant==n.被告
deflation==n.通貨緊縮
delectable==adj.美味的,好吃的
demolish==v.拆除,拆毀
demonstrator==n.示威者
deny==v.否定,否認/拒絕
departure==v.出發,離開
dependent==adj,依靠的,依賴的
deposite==n.存款/押金/訂金
depreciate==v.減價,貶值
deputy==n.代理人,代表
describe==v.描述,描寫
deserve==v.值得, 應得
designate==v.指定
designer==n.設計師
desire==v./n.渴望,希望,想要
despite==prep.儘管
destination==n.目的地
detach==v.分開,拆卸/使分離
detector==n.探測器,檢驗器
detour sign==改道標誌
detour==n.繞道,繞行的路,繞行路線,改道
diagram==n.圖解,圖表
dialect==n.方言,土語,地方話
diameter==n.直徑
diaper==n.尿布
dimension==n.空間/尺寸
direct==v.引導
directly==adv.直接地
discard==v.丟棄,拋棄
disposal==n.處理,清除
disregard==n.漠視,忽視(+for)
v.忽視
distract==v.使分心
diverge==v.分岔
do judo==柔道
do push-ups==伏地挺身
do sit-ups==仰臥起坐
dock hands==船夫
dock==n.碼頭
doubt==v.懷疑
doubtless==adv.無疑地,肯定
downturn==n.(經濟)衰退,不景氣
drama queen==喜歡小题大做的人/公主病
drastic measures==嚴厲的措施
drastic==adj.嚴厲的,猛烈的,激烈的
drug store==藥局
drug==n.毒品
dualism==n.二元論
dubious==adj.令人懷疑的/可疑的
duplicate==v.複製
n.複寫紙
duty==n.義務,職責/關稅
eager==adj.熱切的,渴望的
ecocide==n.破壞生態,生態滅絕
election==n.選舉
elective==adj.選舉的,由選舉産生的,有選擇的
electrician==n.電工,電氣技師
emit==v.散發(出來)
emphasis==n.強調
employ==v.僱用
employee==n.員工
employment==n.雇用,就業
enclose==v.隨信(或包裹)附上/把...圍起來,圍住
enclosed==adj.隨函附上的,附上的
endeavor==v./n.努力
energetic==adj.精力充沛的,有活力的
engineer==n.工程師
enrollment==n.登記/註冊
entertain==v.接待,招待
environmental==adj環境的
era==n.時代,年代
erode==v.侵蝕,腐蝕
escape==n./v.逃跑,逃脫
essential==adj.必要的
estimate==n.估價(單)
ethnic==adj.種族的,民族的
etiquette==n.禮儀
evacuation==n.疏散,撤離
eventual==adj.最終的,最後的
excavate==v.挖掘
excavation==n.挖掘
exceed==v.超過
exception==n.例外
exclusive==adj.獨有的,獨佔的
excuse==v.原諒,寬恕
executive officer==執行長
executive==n.高階主管=chief
exhaust==n.排氣管
v.使筋疲力竭,使疲憊不堪
exhibit==v.展出
n.陳列品
exhibition==n.(大型、綜合)展覽會
exist==v.存在
exotic==adj.異國的,外來的/奇異的
expect==v.預料,預期
expectation==n.期待
expire==v.到期,結束/死亡
expose==v.使暴露,受到
exterior==adj.外部的,外面的
extraordinary==adj.非凡的,令人驚奇的
extremely==adv.非常
eyewitness==n.目擊證人
fabric==n.布料
fabulous==adj.極好的,相當好的
facilities==設施
facility==n.場所/facilities設施
factory==n.工廠
family gathering==家庭聚會
fancy==adj.高級的,華麗的
fare==n.(交通工具的)票價,車(船)費=fee
farewell==n.告別
fast-paced==快速進行的
fasten==v.繫緊,固定
feature==n.特徵,特色
federal==adj.聯邦(制)的,聯邦政府的
field==n.田野/(通常有草坪的)運動場
figure out==弄清楚/理解
figure==n.數字,數量/身材=body
file clerk==檔案員
file==v.歸檔
finance==v.提供資金,資金支援
firm==n.公司
flash-frozen==急速冷凍
flavor==n.口味,味道
floor lamp==n.落地燈
fold==v.折疊,對折(指紙或布)/可折疊
force==n.力量/暴力,武力
forceful==adj.強力的
forecast==n./v.預測
forefather==n.祖先
foreman==n.領班,工頭
form==n.類型,種類
fortune==n.財產,財富
forward==v.轉寄,傳遞
fragile==adj.易損壞的
frame==n.(圖畫、門、窗的)框,框架
framework==n.結構,體制
franchise==n.特許經營權
fraud==n.詐騙(罪),詐欺
frequently asked question==常見問題,常問問題=FAQ
fuel==n.燃料
fulfill==v.履行/完成/達到(目的)
function==n.功能,用途
fund==n.資金,基金
furnish==v.裝潢,佈置(傢俱)
futures==n.期貨
gadget==n.小器具
gain==v.獲得
gallery==n.藝廊,畫廊
gather==v.聚集
generate==v.造成,發生
girder==n.大樑
gradually==adv.逐漸地
grand==adj.雄偉的,壯麗的/主要的,首要的
grant==v.同意,允許/給予
graph==n.圖表,長條圖=chart
grateful==adj.感激的,感謝的
gratefully==adv.感激地
grievance==n.不滿,抱怨,委屈
guarantee==n.保證(書),擔保
guide==n.手冊,指南/旅行指南
haircutter==n.理髮師
hairstylist==n.髮型設計師
hallway==n.玄關/走廊
halt==v.停止,中斷
hammer==n 鐵鎚
hand==v.交給
handicap==n.殘障,殘疾
handicraft==n.手工藝品
handkerchief==n.手帕
handyman==n.工人,雜工,修理匠
hard hat==工地安全帽
hare==n.野兔
harsh==adj.嚴厲的,嚴酷的
head over heels==墜入愛河head over heels (in love)
heat==n.供暖系統,暖氣設備
hectic==adj.忙亂的,繁忙的
helmet==n安全帽
hesitate==v.猶豫,躊躇
hindrance==n.阻礙,障礙
hold==v.容納
homeless==adj.無家可歸的
n.流浪漢
homeowner==n.屋主
hopeless==adj.沒希望的
horrible==adj.極糟的,恐怖的
housekeeper==n.管家,房務員
hybrid==n.油電混合車
icon==n.偶像/圖像/圖示
immigrant==n.移民
impact==n.影響,作用/衝擊(力)
impede==v.妨礙,阻礙
impose==v.強制實行,推行
in a hallway==在走廊上
in charge of==負責=be responsible for
in exchange for==以交換......
in favor of==有利於
in spite of==儘管=regardless of
inadequate==adj.(數量)不充足的/不夠好的,劣質的
incentive==n.獎勵,鼓勵
inclement==adj.天氣險惡的,氣候嚴酷的
incorporate==v.包含
increase==v.增加
indeed==adv.確實,的確
indication==n.徵兆,象徵
industry==n.工業,產業
infant==n.嬰兒
infatuated==adj.(通常短期)熱戀的,著迷的
inference==n.推理,推論,推斷,推測
Inflate==v.使充氣,使膨脹
inflation==n.通貨膨脹
informal==adj.非正式的
informative==adj.提供資訊的/見識廣博的,有益處的
initial==adj.最初的,開始的
initially==adv.起初,最初,一開始
initiative==n.主動,主導權
injure==v.受傷,損害
inquire==v.打聽,詢問
inquiry==n.詢問,打聽
insist==v.堅持
inspect==v.檢查
inspection==n.檢查,檢驗
inspector==n.檢查員,視察員,督察員
installment==n.分期付款
institute==n.研究所,學院
instructions==n.使用說明,操作指南
insurance==n.保險
integral==a. 構成整體所必需的
intellect==n.才智,智力
intellectual==adj.智力的
n.知識分子
intention==n.企圖,打算
interior==n.內部
intersection==n.交叉路口,十字路口/(兩條線的)相交,交點
interviewee==n 接受面試者,接受採訪者,被訊問者
intrude==v.入侵,闖進/打擾
inventory==n.存貨清單,庫存
invest==v.投資,投入
investigate==v.調查,審查
invitation==n.邀請(卡)
invoice==n.發票,發貨單
involvement==n.參與/涉入,介入
issue==n. 發行刊物,期刊
jealous==adj.忌妒的
jet lag==時差
jewel==n.珠寶,寶石
jewelry==n.(總稱)珠寶,首飾
job==n.工作,職業=occupation
journal==n.雜誌,期刊
journalism==n.新聞業,報章雜誌業
journalist==n.新聞工作者
judge==v.(尤指認真考慮之後)斷定,判斷,估計
n.法官/(比賽的)裁判員
Keynote address==主題演說,專題演講
kiosk==n.(售糖果、飲料、報紙等的)亭子
kisses and hugs==接吻與擁抱=XO
kitchenware==n.廚房用具
labor and parts==人力及零件
labor==n.勞動,勞工
laboratory technician==實驗室技術人員
lack==v./n.缺少,缺乏
lamb==n.羊肉
landlord==n.房東/地主
landscape==n.風景(畫)
v.造景
lane==n.小巷/車道/航道/跑道
lately==adv.最近
lawn==n.草地,草坪
lawyer==n.律師
layoff==n.解雇,裁員
lead==v.領導,帶領
leak==n.(水,瓦斯等的)漏出/漏洞
lean against==倚靠
lease==n.租約,契約,租賃契約
v.租借,租用
lecture==n.演講,(尤指面向學生的)講座,課
length==n.長度
lent==v.借給,借出
librarian==n.圖書館員
license==n.執照,許可證
lid==n.蓋子
lie==n.位於,坐落在
lighting technician==n.燈光師
likewise==adv. 同樣地
line==n.(商品)種類
loop==n.圓圈,環形
lot==n.一塊地,場地
lounge==n.休息室
loyal==adj.忠誠的
luggage==n.行李
lying==v.躺,平躺
madam==n.(對婦女的恭敬稱呼)女士,夫人,太太
magician==n.魔術師
make-up artist==n.化妝師
manipulate==v.操縱,操作
manner==n.方式,方法
manual==n.使用手冊,說明書
manufacturer==n.製造商
manuscript==n.手稿,原稿
marker==n.白板筆,記號筆
marvellous==adj.絕妙的,極好的
maternity==adj.懷孕的,產婦的
meanwhile==adv.(與其)同時,在此期間
measure==v.測量/衡量
memorandum==n.備忘錄,便箋
merchant==n.商人,(尤指外貿)批發商
merge==v.(商場)合併,併購
merit==n.功勞,功績/價值/好處,優點
metal worker==n.焊接工人,金屬工人
meter==n.公尺
v.測量,計量
metropolitan==adj.大都市的
mill==n.製造廠,工廠
minutes==n.會議記錄
miscellaneous==adj.混雜的,各種各樣的
misfortune==n.不幸,災禍
misrepresent==v.誤傳
missionary==n.傳教士
model==n.型號,款式
modify==v.修改,修正
mogul==n.大人物,重要人物
monologue==n.獨白,(一個人)滔滔不絕地說話
monopolize==v.壟斷，獨佔
monopoly==n.壟斷、獨占
moreover==adv.而且,此外
mortgage==n./v.抵押
mortician==n.殯葬業者,禮儀師
multiple==adj.多個的/多種的
n.倍數
musician==n.音樂家
nail==n.釘子/指甲
napkin==n.餐巾(紙)
nasty==adj.人討厭的/不友善的,惡意的
negate==v.否定, 取消
neglect==v./v.忽視,疏忽,忘記
negotiator==n.談判者,談判專家
Never put off what you can do today until tomorrow.==今日事,今日畢
newsletter==n.(機構定期寄發給成員的)通訊,簡報
newsstand==n.書報攤
niche==n.合適的工作或活動,合適的位置
niece==n.侄女,外甥女
normally==adv.正常,通常
northbound==adj./adv.向北(的),北行(地)
novice==n.新手,初學者
numerically==adv.數字地
object==v.反對
objective==n.目標
adj.客觀的
observe==v.觀察/遵守
observer==n.觀察員,觀察家
obsessed==adj.著迷的,困擾的,心神不寧的
obstacle==n.障礙,阻礙,妨礙
obtain==v.得到,獲得
occasion==n.(尤指某事發生的)時刻/場合,盛會
occupancy==n.居住/佔用
occupant==n.居住者/佔有人,佔用者
occupation==n.工作,職業
odd==adj.不常發生的/奇特的,古怪的
off-limits==禁止進入的,禁止入內的
omission==n.遺漏,疏忽
on the job==在職場上
ongoing==adj.進行中的,持續存在的
operate==v.操作,使用/運轉,運作/營運
operator==n.操作人員/接線員
opinion==n.意見,看法
opponent==n.對手;敵手,反對者
opposite one another==倆倆相對
opposite==adj.全然不同的/相反的,對立的
prep.在...對面
optimistic==adj.樂觀的
option==n.選擇
oral presentation==口頭發表
oral==adj.口頭的,口述的
n.口試
order==n.秩序
ordinary==adj.普通的,平常的,一般的,平凡的
orientation==n.定向,目標/方向/新生訓練
outbuilding==n.附屬建築物
overactive==adj.過動的,過度活躍的
overall==adj./adv.整體來說
overcharge==v.超收費用/過度充電
overcome==v.克服/戰勝
overdue==adj.逾期的
overestimate==v.高估,評價過高
overhang==n.突出物
overhear==v.無意間聽到
overlook==v.忽視,忽略/眺望
overpass==n.天橋,高架
overrule==v.駁回,否决
overthrow==v.顛覆,推翻/投(球)過猛
overtime==adv.超時,加班
pace==n.(移動的)步調/(發生的)速度,節奏
parallel==adj.平行的/相同的,類似的
participant==n.參加者,參與者
particularly==adv.尤其,特別地=especially
partition==n.隔開,隔牆
patent==n.專利(權)
pattern==n.模式,方式,形式
pavement==n.人行道=sidewalk
paycheck==n.薪水,工資
payment==n.付款,支付(的款項)
payroll office==出納室,工資辦公室
payroll==n.薪水帳冊,發薪名單
pedestal==n.基座,底座
pedestrian crossing==斑馬線,行人穿越道
pedestrian overpass==(行人專用)天橋
percentage==n.百分比,百分率
perhaps==adv.或許,可能
perimeter==n.(圓)周長/周邊,邊緣
period==n.期間
permit==v.允許
n.許可證,執照
pesticide==n. 殺蟲劑,農藥
pharmacist==n. 藥劑師
phase==n.時期,階段
v.逐步進行
photograph==n.照片,相片
v.照相,攝影
photographer==n.攝影師/照相師
photography==n.攝影
picket==n.糾察隊/示威遊行
pickup==n.恢復景氣,好轉/增加,提高
pile==n.一堆,疊
pillow==n.枕頭
pilot==n.飛行員
pipe==n.管子,(水)管
pitcher==n.大水壺/(棒球)投手
place setting==一套餐具,擺設
plaintiff==n.原告
plant==n.植物/機器,設備,工廠
plate==n.盤子/碟
playhouse==n.劇場,劇院
pleasant==adj.令人愉快的,宜人的,親切友好的
please==請=PLS
plumber==n.水管工人,水電工
plywood==n.夾板,合板
polite==adj.有禮貌的
political opponent==政敵
porch==n.門廊,玄關
porter==n.行李員,門房=doorman
portrait==n.肖像(畫)
possible==adj.可能的
postgraduate==n.研究生
postpone==v.延期
postscript==n.附記,(正文後的)附言,補充說明=PS
postwar==adj. 戰後的
pot==n.盆,罐,壺/一罐(一壺,一瓶等)的量
potential==adj.潛在的
potentially==adv.可能地,潛在地
practice==n.習慣,慣例/習俗/練習,訓練
prearrange==v.預先安排
precaution==n.預防(措施)
precise==adj.精確的/準確的,確切的
preclude==v.(事先)排除/防止/阻止
prediction==n.預計,預測
prejudice==n. 偏見,成見,歧視
v. 使產生偏見
premature==adj. 過早的,早產的/不成熟的/倉促的
premises==n.營業場所
prescribe==v.開處方,開藥方
presentation==n.演講,簡報
preservation==n.保護,保養,保藏
pressure==n.壓力
prevail==v.佔優勢,占上風/勝過,勝出
previously==adv.先前地,以前地
priority==n.優先考慮的事/優先權
private==adj.私人的,私有的/不公開的
probation==n.(法律)緩刑,假釋/(公司)見習,實習
proceed==v.繼續進行/著手
productive==adj.多產的,增加產量的
profession==n.職業=occupation=job
professor==n.教授
proficient==adj.精通的,熟練的
program==n.節目(單)/計畫/程式
prohibit==v.禁止,防止,阻止
projector==n.投影機
prompt==adj.迅速的
pronunciation==n.發音
property==n.財產,資產/(拍電影用的)道具
proposal==n.提案
propose==v.計劃,建議
prosecutor==n.檢察官
protest==n.抗議,反對
protester==n.抗議者
provider==n.提供者,供應商
proximity==n.鄰近,接近
psychologist==n.心理學家
publish==v.出版,刊登
pull==v.拉,拖
punctual==adj準時的,守時的
pursu==v.追求
push in==推入
qualification==n.資格,條件
quantity==n.量,數量
question and answer==問與答=Q & A
quilt==n.棉被
quota==n.(商品)配額,定額,限額
quote==v.引用/舉出
railing==n.(通常指金屬或木頭的)欄杆
ranch==n.大牧場,大農場
random==adj.胡亂的
reach==v.到達/達到/伸手拿
n.伸手可及的距離
readjust==v.重新調整,微調
realtor==n.房地産代理,房屋仲介
rear==adj.後面的,背後的=back
recall==v.召回,回收
receive==v.收到,接到
reception==n.歡迎會/接待(處)
reconfirm==v.再確認,再證實
recruit==v.招募
reference==n.推薦信,介紹信/參考
refill==n./v.再次填充滿...的量,續杯
refinery==n.精煉廠,提煉廠
refuse==v. 拒絕
regarding==prep.關於,至於
regardless of==儘管=in spite of
register==v.登記,註冊
registration==n.登記/註冊/掛號
regret==v.懊悔/抱歉/遺憾
regulatory==adj.管理的
rehearse==v.排練,預演
reimburse==v.償還,補償
reimbursement==n.費用核銷
relation==n.關係
relatively==adv.相對地
reliability==n.可靠性,可依賴性
relieve==v.減輕
relinquish==v.放棄(權力、地位),辭去
relocate==v.重新安置,(使)搬遷
rely==v.依靠
remodel==v.重新塑造,重建
removal==n.移動,除去
remove==v.排除,移除
renovate==v.修復,裝修,翻新(尤指舊建築)
rent==n.租金,房租
v.租用,租出
rental==n.出租,租金
repair personnel==維修人員,修理(護)人員
replaceable==adj.可替換的
reported==adj.據報告的/據報導的/據傳聞的
represent==v.代表=stands for/提出,表達
representative==n.代表,代理人
request==v./n.(正式的)要求,請求
residence==n.住所,住宅
resign==v.辭職
resistance==n.抵抗
resort==n.度假勝地
respond==v. 回答,回應
response==n. 回答,回應
responsible for==負責=in charge of
retailer==n.零售商
retain==v.保留,維持
retrieve==v.找回,重新得到
reverse==n.相反
revise==v.修改,修正
revision==n.修正,修改
risk==n.危險,風險
road closure==道路封閉
roast==v.烤/烘
roof==n,屋頂/車頂
route==n.路線
rug==n.毯子/地毯
rule out==排除
rural==adj.鄉村的,農村的/似鄉村的
sail==v.(船)航行
n.帆
sailor==n.海員,水手
salesperson==n. 售貨員,推銷員,店員
salon==n.美容院/會客室
satisfied==adj.感到滿意的
satisfy==v.使滿意,使滿足
sauce==n.調味醬,醬料
saucer==n.茶碟,茶託
savory==adj.風味極佳的,可口的,味美的
scholarship==n.獎學金
scientific==adj.科學的
scientist==n.科學家
screen==n.投影幕,螢幕
sculpture==n.雕刻(作品)
seal==n.封口/印章/封條
season==v.調味,醬料
secretary==n. 秘書(複數secretaries)
secure==v.獲得
security guard==警衛,保全人員
semidiameter==n.半徑
seminar==n.研討會
seminar==n.研討會
senior==adj.級別高的
set for==擺設/設置
set==n.(拍電影用的)佈景
setback==n.障礙/挫折
shareholder==n.股東
shed==n.(通常爲木質,存放物品用的)棚子,小屋,倉庫
sheet==n.床單
shelf==n.架子
shipment==n.運輸
shipping agent==海運代理商,快遞代理商
shortfall==n.不足,差額
side by side==並排
sidewalk==n.人行道=pavement
simplify==v.簡化
skeptical==adj.懷疑性的
slender==adj.苗條的,纖細的
snail==n.蝸牛
snare==n.陷井,羅網
solar==adj.太陽的
sore==v.擦傷
specific==adj.特定的,特有的
specification==n.說明書
specify==v.具體指出,詳細說明
spot==n.地點,場所
square==n.正方形/廣場
stadium==n.體育場
stairway==n.樓梯
stand-in==n.替身(演員)
stand==n.架子
startup==n.啟動,發動
statistics==n.統計學
statue==n.雕像
status==n.狀態/地位
steel==n.鋼鐵
still life==靜物(畫)
stockbroker==n.股票(或證劵)經紀人(經紀公司)
stool==n.凳子,板凳
storage==n.儲存,儲藏,儲備/儲藏室
story==n.樓層(量詞)
stove==n.爐,瓦斯爐
stow==v.貯藏
stranger==n.陌生人/外地人
strategic==adj.戰略(性)的,策略(上)的
street vendor==街頭小販,路邊攤販
streetlamp==n.街燈,路燈=streetlight
strengthen==v.加強,增強
strenuous==adj.費力的/耗費精力的
strike==v.罷工
stroke==n.中風
submarine==n.潛水艇
submerge==v.浸沒, 淹沒,使潛入水中
submit==v. 提交,
subnormal==adj.低能的,低於正常標準的
subscribe==v.訂閱(購)
substantial==adj.大量的
substantiate==v.證實,具體化
substitute for==代替,取代
substitute==v.用...代替
subtract==v.減去,減
suburb==n.郊區,市郊住宅區
suffer==v.經歷/受折磨,受苦/遭受
suicide==n.自殺(者)
suit==n.套裝
suitcase==n.手提箱
superficial==adj.表面的/(人)膚淺的, 淺薄的
superintendent==n.(大樓的)看管人/主管,負責人
superman==n.超人
superpower==n.超級大國
superstitious==adj.迷信的
supervisor==n.監督者,管理人,指導者
surgery==n.(外科)手術
survive==v.存活,生存
suspicious==adj.可疑的
sustainable==adj.可持續的,能維持的
tablecloth==n.桌布,枱布
tailor-made==adj.特製的,訂做的
tailor==n.裁縫師
take off==脫掉/起飛
tank==n.(盛放液體或氣體的)容器/坦克
tariff==n.關稅
tear==v.(被)撕開,(被)撕掉
tear\tore\torn
technical==adj.技術的/專門性的
technician==n.技術人員,技師
telegram==n.電報=telegraph
telegraph==n.電報=telegram
telephone pole==電線杆
teller==n.(銀行)出納員
temporary==adj.暫時的,短暫的
tenant==n.承租人,房客
terminal==n.(機場)航廈
terms==n.條款
terrible==adj.可怕的
terrorist==n.恐怖分子
testimony==n.(尤指法庭上的)證詞
thermometer==n.溫度計
thoroughly==adv.非常/徹底地
thoughtful==adj.體貼的
thoughtfully==adv.體貼地
throughout==adv./prep.遍及
tire==n.輪胎
to one side of==在...的旁邊
tone==n.(常指對聽話人的)語氣,腔調,口吻
toner==n.碳粉(the boxes of the toner)
tour==n.(工廠、設施等的)參觀/短期旅行
tower==n.塔,高樓
trade==n.貿易,交易,生意
trading==n.交易
traffic light==紅綠燈
traffic sign==交通號誌
transaction==n.交易
transcribe==v.紀錄/轉寫
transcription==n.記錄/抄寫
transform==v.變形
transfuse==v.滲透/輸血
transmit==v.發射,傳送(信號)/傳遞,傳播
transport==n.(交通)運輸,運送,輸送/交通工具
trap==n.陷阱
trauma==n.精神創傷,心理創傷/外傷
tree branch==樹幹
trend==n.趨勢,傾向/時尚
trilateral==adj.對三方有關係的
trim==v.修剪/整理
trolley==n.手推車/有軌電車
troubleshoot==v.疑難排解
tuition==n.學費
turn away==轉過去/逃避
turn down==拒絕
turn in==繳交=submit
turn on==打開,開啟
turn up==出現=appear
twig==n.細枝,嫩枝
unanimous==adj.全體一致的
unanimously==adv.全體一致地
underestimate==v.低估,估計不足/看清
underpass==n.地下道
unfurnished==adj.沒有傢俱的
unicorn==n.獨角獸
uniform==n.制服
unify==v.統一/一致
union==n.工會
unique==adj.獨一無二的
unite==v.統一/整合
universal==adj.宇宙的/普遍的
university==n.大學
unmade==adj.(床鋪)未整理的
unpleasant==adj.令人不愉快的
unproven==adj.未經證實的
urban area==市區
urban==adj.都市的,居住在城市的
useless==adj.無用的,無效的
utility==n.(電、煤氣、鐵路等)公共設施,公共事業/實用性
vacate==v.騰出,空出,離開
vaild==adj.有效的
valid==adj.(票或其他)正式認可的/有法律效力的
van==n.廂型車,麵包車
variant==adj.有差異的,不同的
n.變形,變化
variation==n.變化
variety==n.多樣性,多樣化
various==adj.不同的,各式各樣的
vehicle==n.車輛,(陸上)交通工具
vendor==n.小販,賣主
versatile==adj.多才多藝的
version==n.版本
victim==n.受害者,罹難者
violation==n.違反/侵犯
virus==n.病毒
visible==adj.可看見的
vital==adj.極其重要的
volunteer==n.志願者,志工
vote==v.選舉,投票,表決
voucher==n.折價券,現金卷,票券
wagon==n.四輪運貨馬車
waive==v.放棄(權利)/不遵守(規則)
walkway==n.(尤指有篷或高架的)走道,人行道
warrant==n.逮捕令
warrenty==n.保證書,保卡
whenever==adv./prep.無論何時
whiteboard==n.白板
wide==adj.寬的
wildly==adv.失去控制地
wire==n.電線/金屬線
withdraw==v.撤回,撤離
within==prep.在...之內
witness==n.目擊者
worker==n.工人/工作者
workman==n.工人,工匠
workmanlike==adj.做工精細的,技術純熟的
workmanship==n.手藝,做工
worth==adj值得的
wrap==v.包裝/用...包裹

ASSURANCE==binding commitment to do or give or refrain from something
assure==inform positively and with certainty and confidence
attract==exert a force on
attraction==arousing interest
cancel==declare null and void, 
call something off
characteristic==distinctive, typical
comparable==able to be described as similar
compare==Give an account of the similarities between two (or more) items
competition==the act of contending as for profit or a prize
consume==take in as food, use eat
consumer==A person who purchases goods and services for personal use
CONTRACT==A binding agreement between two or more persons that is enforceable by law
convince==make (someone) agree, understand, or realize the truth or validity of something
DETERMINE==adj. strong in one's opinion, firm in conviction, to find out
ENGAGE==consume all of one's attention
ESTABLISH==set up or found, start, begin
fad==an interest followed with exaggerated zeal
inspiration==arousal of the mind
obligation==the state of being bound to do or pay something; duty, responsibility
obligatory==required
persuasion==The process of creating, reinforcing, or changing people's beliefs or actions.
productive==capable of bringing forth
provide==give something useful or necessary to
provision==the activity of supplying something
PROVISION==the activity of supplying someting
RESOLVE==Find a solution to
satisfactory==meeting requirements; giving contentment
satisfy==Placate; meet the requirements or expectations of
specific==stated explicitly or in detail, exactly
specification==naming explicitly, an act of identifying something precisely or of stating a precise requirement
specify==to state, name or mention exactly and clearly, be particular about


abide by==(v) tuân thủ
ability==(n) năng lực, khả năng
abundant==(adj) nhiều, phong phú, thừa thãi
accept==(v) chấp nhận, thừa nhận
access==(v) truy cập
accommodate==(v) dàn xếp, đáp ứng, làm thích nghi
accomplishment==(n) thành tựu, sự hoàn thành
accounting==(n) sự tính toán, công tác kế toán
accumulate==(v) cộng dồn; tích luỹ lại
accurate==(adj) chính xác
accustom to==(v) làm cho quen, tập cho quen
achieve==(v) thành công, đạt mục tiêu
acquire==(v) đạt được, giành được, thu được, kiếm được
action==(n) hành động; quá trình diễn biến
address==(v) hướng tới, nhắm đến
adhere to==(v) tôn trọng, giữ vững, tuân thủ
adjacent==(adj) gần kề, sát ngay
adjust==(v) điều chỉnh, dàn xếp, làm cho thích hợp
admire==(v) ngưỡng mộ
admit==(v) cho vào, nhận vào
advance==(n) sự tiến bộ
affordable==(adj) giá cả phải chăng
agency==(n) đại lý, chi nhánh, sở, hãng
agenda==(n) chương trình nghị sự
aggressive==(adj) quyết đoán; cạnh tranh, hung han
agreement==(n) hợp đồng, sự thống nhất chung
allocate==(v) phân bổ
allow==(v) cho phép, chấp nhận
alternative==(n) sự lựa chọn (một trong hai); phương án thay thế
announcement==(n) lời tuyên bố, cáo thị, lời thông báo
annual==(adj) hàng năm
anxious==(adj) lo lắng; băn khoăn
appeal==(adj) hấp dẫn, lôi cuốn
apply==(v) nộp hồ sơ ứng tuyển
appointment==(n) sự hẹn gặp, chức vụ được bổ nhiệm
appreciate==(v) hiểu, nhận thức rõ
apprehensive==(adj) lo lắng, sợ hãi (về tương lai)
apprentice==(n) người học việc, sinh viên tập sự
approach==(v) tiếp cận, lại gần; (n) sự tiếp cận, cách tiếp cận
arrangement==(n) sự sắp xếp, kế hoạch
arrive==(v) đến nơi
as need==(adv) khi cần
ascertain==(v) tìm hiểu chắc chắn, xác định
aspect==(n) khía cạnh, mặt, diện mạo
assemble==(v) thu thập, tụ tập
assess==(v) định giá, đánh giá
asset==(n) tài sản
assignment==(n) sự phân công, sự giao việc, việc được giao
assist==(v) giúp đỡ, trợ giúp
association==(n) tổ chức, hiệp hội
assume==(v) cho là đúng, thừa nhận
assurance==(n) sự đảm bảo
attain==(v) đến tới, đạt được
attend==(v) tham gia, hướng tới
attitude==(n) thái độ
attract==(v) thu hút
audience==(n) khán giả, người xem
audit==(n) công việc kiểm toán, sự kiểm tra sổ sách; (v) kiểm toán
authorization==(n) sự cho phép, sự cấp phép, sự phê chuẩn
automatic==(adj) tự động
available==(adj) có sẵn, sẵn sàng để dùng
avoid==(v) tránh
aware==(adj) biết, nhận thấy
background==(n) quá trình học tập
balance==(n) số dư tài khoản; bản quyết toán thu chi; (v) quyết toán, cân đối tài khoản
bargain==(n) sự mặc cả, món hời
basic==(adj) cơ bản, cơ sở
basis==(n) nền tảng, cơ sở, căn cứ
be aware of==(v) nhận thức được, ý thức được
be exposed to==(v) đúc kết kinh nghiệm
be in charge of==(v) chịu sự điều khiển , có trách nhiệm
be ready for==(v) sẵn sàng cho, đã chuẩn bị cho
bear==(v) chịu, chịu đựng
beforehand==(adv) sẵn sàng trước
behavior==(n) cách cư xử
benefit==(n) lợi ích; (v) được lợi
beverage==(n) đồ uống
blanket==(n) chăn; (v) phủ lên, che phủ, trùm chăn
board==(v) lên tàu/ ăn cơm trọ
borrow==(v) vay, mượn
brand==(n) mác sản phẩm, nhãn hàng
bring in==(v) thuê mướn, dẫn tới
bring together==(v) tập hợp, thu thập
bring up==(v) đề cập tới (1 chủ đề...)
broad==(adj) rộng, bao la, mênh mông
budget==(n) ngân sách, ngân quỹ
build up==(v) làm tăng theo thời gian, tăng theo thời gian
burdensome==(adj) nặng nề, gánh nặng
busy==(adj) bận rộn/ náo nhiệt, đông đúc
calculate==(v) tính toán
call in==(v) yêu cầu, gọi tới
cancel==(v) huỷ bỏ
candidate==(n) ứng cử viên, người dự tuyển
capacity==(n) sức chứa
carrier==(n) người chuyển hàng, người đưa thư
casual==(adj) thông thường
catalog==(n) bảng liệt kê mục lục; (v) ghi vào mục lục, chia từng loại
catch up==(v) đuổi kịp, bắt kịp
category==(n) hạng, loại
cautious==(adj) thận trọng
chain==(n) chuỗi, dây chuyền (làm việc)
characteristic==(adj) đặc tính, đặc điểm
charge==(v) tính giá; (n) tiền phải trả
check in==(v) đăng ký tên (khách sạn, sân bay)
checkout==(n) sự thanh toán tiền (khách sạn, ...), nơi thanh toán tiền, hành động thanh toán tiền...
choose==(v) chọn, lựa
circumstance==(n) điều kiện, hoàn cảnh, tình huống
claim==(v) đòi hỏi, yêu sách, thỉnh cầu/ lấy lại, tìm lại được (vật đã mất)
client==(n) khách hàng
code==(n) lề thói, tập quán
coincide==(v) xảy ra đồng thời, trùng khớp với nhau
collaboration==(n) sự cộng tác
collection==(n) bộ sưu tập, sự sưu tầm
combine==(v) kết hợp, phối hợp
come up with==(v) phát minh, tạo ra
comfort==(n) sự hài lòng, sự thuận tiện; (sn) tiện nghi
commensurate==(adj) đúng với, xứng với, tương ứng với
commitment==(n) sự cam kết
common==(adj) phổ biến, thông thường
compare==(v) so sánh
compatible==(adj) tương thích
compensate==(v) đền bù, bồi thường, trả cho
compete==(v) đấu tranh, cạnh tranh
compile==(v) thu thập tài liệu
complete==(adj) đầy đủ, trọn vẹn, hoàn toàn
complicated==(adj) phức tạp, khó hiểu
comprehensive==(adj) bao gồm, kể cả/ sáng ý
compromise==(n) sự thoả hiệp
concentrate==(v) tập trung
concern==(v) liên quan, dính líu, quan tâm; (n) việc phải lo
conclude==(v) kết thúc, kết luận
condition==(n) điều kiện
conducive==(adj) đưa đến, dẫn đến/ có ích, có lợi
conduct==(v) tiến hành, thể hiện, cư xử; (n) cách cư xử
confidence==(n) sự tự tin
confirm==(v) xác nhận, phê chuẩn
conform==(v) làm cho phù hợp, làm cho thích hợp
confusion==(n) sự mơ hồ, sự rối rắm
consequence==(n) hậu quả, kết quả
conservative==(adj) dè dặt, thận trọng
consider==(v) cân nhắc, xem xét
constant==(n) hằng số; (adj) không đổi
constantly==(adj) liên tục
constitute==(v) cấu thành
consult==(v) hỏi ý kiến, tham khảo
consume==(v) tiêu thụ, tiêu dùng
contact==(v) liên hệ, liên lạc
continue==(v) tiếp tục, tiếp diễn, duy tri
contribute==(v) đóng góp, góp phần
control==(v) chỉ huy, điều khiển, kiểm soát
convenient==(adj) thuận tiện, dễ dàng
convince==(v) thuyết phục (= persuade)
coordinate==(v) phối hợp, sắp xếp (công việc)
courier==(n) người đưa thư
cover==(v) bao bọc, bao gồm, bảo vệ, che đậy
create==(v) sáng tạo, tạo nên
criticism==(n) sự phê bình, lời bình phẩm
crucial==(adj) quan trọng, nổi bật
culinary==(adj) liên quan tới bếp núc
current==(adj) đang tồn tại, đang thịnh hành
customer==(n) khách hàng
daring==(adj) táo bạo, liều lĩnh
deadline==(n) hạn chót, hạn cuối cùng
deal with==(v) chú trọng, chăm lo/ giải quyết, xoay sở
debt==(n) món nợ, khoản nợ
decade==(n) thập kỷ
decisive==(adj) quả quyết; dứt khoát
dedication==(n) sự cống hiến
deduct==(v) lấy đi, trừ đi
defect==(n) sự sai sót, khuyết điểm, lỗi
delay==(v) trì hoãn; (n) khoảng thời gian trì hoãn
delete==(v) xóa bỏ
delicate==(adj) tinh tế, tế nhị
delivery==(n) sự phân phát, sự giao hàng
deluxe==(adj) sang trọng, xa xỉ
demanding==(adj) đòi hỏi khắt khe
demonstrate==(v) chứng minh, làm sáng tỏ
depart==(v) rời khỏi, khởi hành/ sao lãng, đi lệch
description==(n) sự mô tả, sự diễn tả
designate==(v) chỉ định, chọn lựa, bổ nhiệm
desired==(adj) muốn có
destination==(n) đích, điểm đến
detail==(v) trình bày tỉ mỉ, chi tiết
detect==(v) dò tìm, xác định
determine==(v) quyết định
develop==(v) mở rộng, phát triển, cải tiến
diagnose==(v) chẩn đoán (bệnh)
dialogue==(n) cuộc hội thoại
dimension==(n) kích thước (dài, rộng, cao...)
directory==(n) sách hướng dẫn, sách chỉ dẫn
disappoint==(v) làm thất vọng
discount==(v) giảm giá, triết khấu; (n) sự giảm giá
discrepancy==(n) sự khác nhau, sự không thống nhất, sự bất đồng
disk==(n) đĩa, ổ đĩa
disparate==(adj) khác hẳn nhau, khác loại
disperse==(v) rắc, gieo rắc, truyền (tin)
display==(n) màn hình, hiển thị
disrupt==(v) làm gián đoán, ngắt
disseminate==(v) gieo rắc; phổ biến, khuếch tán
distinguish==(v) phân biệt
distraction==(n) sự xao lãng, sự mất tập trung, sự đãng trí, sự giải trí, thú tiêu khiển
disturb==(v) gây trở ngại, làm phiềm, quấy rầy
diverse==(adj) đa dạng, gồm nhiều loại khác nhau
divide==(v) chia, phân chia, tách rời
dividend==(n) tiền lãi cổ phần
down payment==(n) khoản tiền đặt cọc, trả trước (trong 1 hợp đồng trả góp)
draw==(v) lôi kéo, thu hút
due to==(prep) bởi vì, do
duplicate==(v) tạo bản sao
durable==(adj) bền
duration==(n) khoảng thời gian (tồn tại 1 sự việc)
economical==(adj) tiết kiệm, kinh tế
effective==(adj) có kết quả, có hiệu lực
efficient==(adj) hiệu quả
elegant==(adj) thanh lịch, tao nhã, thơm ngon (món ăn)
element==(n) yếu tố, cơ sở
eligible==(adj) đủ tư cách, thích hợp
embark==(v) lên tàu/ bắt đầu
emphasize==(v) nhấn mạnh, đề cao
encouragement==(n) sự động viên, sự khuyến khích
engage==(v) thuê, mướn
enhance==(v) làm tăng, làm nổi bật
enterprise==(n) hãng kinh doanh
entertainment==(n) sự giải trí, sự tiêu khiển
entitle==(v) cho quyền
equivalent==(adj) tương đương
escort==(n) người dẫn đường, người đi theo, người hộ tống
essential==(adj) cần thiết, không thể thiếu được
establish==(v) gây dựng nên, thành lập, taọ nên
estimate==(v) đánh giá, ước lượng; (n) sự đánh giá
evaluate==(v) đánh giá
everyday==(adj) hàng ngày, thông thường
evident==(adj) hiển nhiên, rõ ràng
exact==(adj) chính xác, đúng đắn
examine==(v) nghiên cứu, khảo sát
excite==(v) kích thích, kích động, đánh thức cảm xúc
excursion==(n) cuộc đi tham quan (với giá hạ có định hạn ngày đi và ngày về)
expand==(v) mở rộng (phạm vị)
expect==(v) mong chờ, trông mong/ nghĩ rằng, cho rằng, chắc rằng
expensive==(adj) đắt
experience==(n) kinh nghiệm, điều đã trải qua
experiment==(v) thí nghiệm, thử nghiệm
expert==(n) chuyên gia, chuyên viên
expire==(v) hết hạn
explore==(v) khảo sát tỉ mỉ
express==(adj) nhanh, hoả tốc (thư); rõ ràng
express==(v) biểu lộ (cảm xúc), bày tỏ (ý kiến)
extend==(v) kéo dài, mở rộng/ dành cho (sự đón tiếp)
facilitate==(v): làm cho thuận tiện
factor==(n) nhân tố, yếu tố tạo thành
fad==(n) mốt nhất thời
fail==(v) thất bại, hỏng, làm sai
fall to==(v) là trách nhiệm (của...)
familiar==(adj) quen thuộc, thông thường
fare==(n) tiền xe, vé (tàu, xe, máy bay)
fashion==(n) mốt, thời trang, kiểu cách
favorite==(adj) được ưa thích, được ưa chuộng
figure out==(v) giải quyết, hiểu ra
file==(n) hồ sơ, tài liệu; dãy người (xếp hàng)
fill out==(v) hoàn thành
flavor==(n) mùi vị
flexible==(adj) linh hoạt, mềm dẻo
fluctuate==(v) dao động, biến động tăng giảm
fold==(v) gấp giấy (thư)
follow up==(v) bước tiếp, tiếp tục
forecast==(v) dự đoán, dự báo; (n) sự dự đoán
forget==(v) quên
frequently==(adv) thường xuyên
fulfill==(v) thực hiện, hoàn thành
function==(v) hoạt động, thực hiện chức năng
fund==(n) quỹ; (v) cấp vốn, tài trợ
garment==(n) hàng may mặc
gather==(v) thu thập, tập hợp
general==(adj) chung chung, tổng quát
generate==(v) tạo ra, sản xuất ra
get in touch==(v) liên lạc, liên hệ
get out of==(v) trốn thoát, đi ra
give up==(v) từ bỏ
glimpse==(n) cái nhìn thoáng qua
go ahead==(v) tiếp tục làm; (n) sự cho phép làm
goal==(n) mục tiêu, mục đích
guide==(n) người hướng dẫn, người chỉ dẫn
habit==(n) thói quen
hamper==(v) cản trở, ngăn trở, làm vướng
hesitate==(v) ngập ngừng, do dự, không nhất quyết,
hire==(v) thuê, tuyển dụng; (n) người làm thuê
hold==(v) tổ chức, tiến hành
housekeeper==(n) người coi nhà, người quản gia
ideal==(adj) lý tưởng, tồn tại trong tưởng tượng
identify==(v) xác định, định danh, nhận dạng, đồng nhất hoá, coi như nhau
ignore==(v) bỏ qua, lờ đi
illuminate==(v) giải thích, giảng giải, làm sáng tỏ
impact==(n) sự tác động, sự ảnh hưởng; (v) tác động mạnh vào
imply==(v) ám chỉ, ngu y
impose==(v) bắt chịu, (+ on, upon) gây tác động mạnh tới
impress==(v) gây ấn tượng, làm cảm kích
in-depth==(adj) tỉ mỉ, kỹ lưỡng, chu đáo, triệt để, hoàn toàn
inconsiderate==(adj) thô lỗ, bất lịch sự, thiếu suy nghĩ
incorporate==(v) sát nhập, kết hợp
incur==(v) hình thành, ra đời, thừa hưởng
indicator==(n) vật chỉ thị, tín hiệu, dấu hiệu
individual==(adj) riêng lẻ, cá nhân, độc đáo, đặc biệt
influence==(v) ảnh hưởng, tác động
influx==(n) sự chảy vào, sự tràn vào
ingredient==(n) thành phần (của 1 hỗn hợp)
initiative==(n) bước đầu, sự sáng tạo; vai trò tích cực
inspect==(v) kiểm tra, thanh tra, theo dõi
inspire==(v) truyền cảm hứng
instinct==(n) bản năng
instrument==(n) công cụ, phương tiên, trang thiết bị
integral==(adj) cần cho tính toàn bộ, tính trọn vẹn
intend==(v) có ý định, có ý muốn
interaction==(n) sự ảnh hưởng lẫn nhau, tác động qua lại
inventory==(n) hàng hoá tồn kho, bảng kê hàng hoá, danh mục hàng hoá
invest==(v) đầu tư
investigative==(adj) thuộc điều tra nghiên cứu (về thông tin bị che giấu), thuộc tìm hiểu sự thật
irritate==(v) chọc tức, kích thích (y học)
item==(n) khoản, mục, món (đồ), đơn vị
itinerary==(n) nhật ký đường đi; lịch trình
joint==(adj) chung, chia sẻ, cùng
judge==(v) phán đoán, đánh giá
keep up with==(v) giữ liên lạc với, bắt kịp với
layout==(n) định dạng trang giấy (bản in)
lead time==(n) tiến độ (thời gian giữa lúc bắt đầu và lúc hoàn thành 1 quá trình sản xuất)
lease==(n) hợp đồng cho thuê, (v) thuê, cho thuê
leisure==(n) thời gian rảnh rỗi, thì giờ rỗi rãi
lengthy==(adj) xa, dài
level==(n) mức, cấp độ
liability==(n) nghĩa vụ, bổn phận, trách nhiệm pháp lý
license==(n) giấy phép
limit==(n) giới hạn, hạn độ
link==(n) mối liên hệ, sự liên kết
list==(n) danh sách; (v) lập danh sách
lobby==(n) phòng giải lao, phòng chờ
location==(n) địa điểm, vị trí
lock into==(v) cam kết
logical==(adj) hợp lý, theo lô gíc
long-term==(adj) dài hạn, lâu dài
look forward to==(v) háo hức, chờ đợi, mong ngóng
look up to==(v) ngưỡng mộ
looked to==(v) phụ thuộc vào, dựa vào
loyal==(adj) trung thành, đáng tin cậy
made of==(v) làm từ, gồm có
maintain==(v) tiếp tục, duy trì, giữ vững
majority==(n) phần lớn, đa số
manage==(v) giải quyết, điều khiển, dạy bảo
mandatory==(adj) tính bắt buộc
market==(v) tiếp thị
match==(n) sự phù hợp, người ngang sức
matter==(n) vấn đề, đề tài, nội dung
mention==(v) đề cập tới; (n) sự nói đến, sự nhắc tới
mentor==(n) người cố vấn
merchandise==(n) hàng hoá
merit==(n) sự tuyệt vời, giá trị cao
method==(n) phương pháp, thủ tục
minimize==(v) giảm tới mức tối thiểu, đánh giá thấp
mission==(n) sứ mệnh, nhiệm vụ
mistake==(n) lỗi
mix-up==(n) tình trạng lộn xộn, cuộc ẩu đả.
mix==(v) trộn lẫn, hoà vào nhau; (n) hỗn hợp
monitor==(v) theo dõi, giám sát (= keep track of)
mortgage==(n) tài sản thế chấp, tiền thế chấp; (v) cầm cố, thế nợ
move up==(v) thăng tiến, thúc đẩy
multiple==(adj) nhiều, phức tạp
narrow==(v) thu hẹp; (adj) chật hẹp, eo hẹp
negotiate==(v) đàm phán
nervous==(adj) dễ bị kích thích, nóng nảy, hay hoảng sợ
network==(n) mạng lưới, hệ thống
notify==(v) khai báo, thông báo, cho biết
obligate==(v) bắt tuân thủ, bắt phải tuân theo
obtain==(v) đạt được, giành được
obvious==(adj) rõ ràng, hiển nhiên
occupancy==(n) sự chiếm đóng, sự cư ngụ
occur==(v) xảy ra, xuất hiện
offer==(v) đưa ra, cung cấp
offset==(v) đền bù, bù đắp
on hand==(adj) có sẵn để dùng
on track==(adj) đúng kế hoạch, đúng lịch, tập trung
open to==(adj) dễ tiếp thu, dễ lĩnh hội
operate==(v) hoạt động, thực hiện chức năng
opt==(v) chọn, quyết định chọn (= decide on)
option==(n) sự lựa chọn
optional==(adj) tuỳ chọn, không bắt buộc
order==(n) đơn đặt hàng; (v) đặt hàng
out of==(adj) hết
outdated==(adj) lỗi thời
outlet==(n) lối thoát; phương tiện thoả mãn (chí hướng)
outstanding==(adj) còn tồn tại, chưa giải quyết xong
overall==(adj) toàn bộ, toàn thể, nói chung, nhìn chung
overcrowded==(adj) quá đông
overview==(n) tổng quan, sự khái quát
owe==(v) nợ, phải trả nợ
party==(n) đảng phái, bên, phía (đối tác)
patron==(n) khách hàng quen, khách hàng thường xuyên
penalty==(n) hình phạt, khoản tiền phạt
perceive==(v) hiểu được, nhận thức được, lĩnh hội
perform==(v) trình diễn, biểu diễn
periodically==(adv) một cách định kỳ
permit==(v) cho phép
personnel==(n) nhân viên, công chức
perspective==(n) viễn cảnh, triển vọng
persuade==(v) thuyết phục (= convince)
pertinent==(adj) phù hợp, có liên quan
petition==(n) đơn yêu cầu, kiến nghị
physical==(adj) thuộc thể chất, thuộc vật chất
pick up==(v) đảm nhiệm, nhận làm
plan==(n) kế hoạch; (v) lên kế hoạch
policy==(n) chính sách
popularity==(n) tính phổ biến, sự ưa chuộng của quần chúng
portfolio==(n) danh mục đầu tư. danh mục vốn đầu tư
portion==(n) phần, đoạn, khúc
position==(n) vị trí, tư thế, địa vị
potential==(adj) khả năng
practice==(n) bài luyện, phương pháp làm
preclude==(v) ngăn ngừa, loại trừ
predict==(v) nói trước, báo trước, dự đoán
preference==(n) sự thiên vị, sự ưu tiên, sự thích hơn
prepare==(v) chuẩn bị
prerequisite==(n) điều cần có trước hết, điều kiện tiên quyết
present==(v) giới thiệu, trình bày, thể hiện
prevent==(v) cản trở, gây trở ngại
primary==(adj) chính, chủ yếu, ưu tiên
priority==(n) quyền ưu tiên, sự ưu tiên hàng đầu
procedure==(n) thủ tục, chuỗi hành động (cần được hoàn thành để thực hiện cái gì).
process==(n) quá trình; (v) xử lý theo tiến trình
productive==(adj) năng suất, hiệu quả
productive==(adj) năng suất, sản lượng cao
profession==(n) nghề nghiệp
profile==(n) sơ lược tiểu sử
profitable==(adj) có lợi, sinh lãi
progress==(n) tiến độ, tiến trình, sự tiến bộ
prohibit==(n) cấm, ngăn cấm
projected==(adj) mang tính chất ước tính (dựa trên số liệu hiện có)
promise==(v) hứa hẹn, đảm bảo
promote==(v) thăng chức, đề bạt; đưa ra
prompt==(adj) nhanh chóng, ngay tức thì; (n) kỳ hạn trả nợ
proof==(v) tìm lỗi
prospective==(adj) thuộc tương lai, sẽ tới về sau
protect==(v) bảo vệ
provider==(n) nhà cung cấp
provision==(n) điều khoản (hợp đồng)
proximity==(n) sự lân cận, trạng thái gần
pull out==(v) rút khỏi, rút lui; (n) sự rút khỏi
punctual==(adj) đúng giờ
qualification==(n) trình độ chuyên môn; (sn) các giấy tờ chứng nhận khả năng
quality==(n) phẩm chất, đặc tính
quote==(v) trích dẫn, định giá; (n) đoạn trích dẫn, lời trích dẫn
raise==(n) sự nâng, sự tăng (lương)
random==(adj) ngẫn nhiên, tình cờ
range==(n) phạm vi, lĩnh vực
rate==(n) loại, hạng, sự đánh giá, sự xếp hạng
realistic==(adj) có óc thực tế
reason==(n) lý do
recognition==(n) sự công nhận, sự thừa nhận
recommend==(v) khuyên, tiến cử
reconcile==(v) làm thích hợp, làm phù hợp
record==(n) hồ sơ, biên bản, sự ghi chép
recruit==(v) tuyển mộ (thêm nhân viên)
rectify==(v) sửa lại cho đúng
recur==(v) quay lại, lặp lại
reduction==(n) sự giảm bớt, sự thu nhỏ
refer==(v) ám chỉ, nhắc đến
reflect==(v) phản chiếu, phản ánh
refund==(n) tiền trả lại; (v) hoàn lại
regardless==(adj) bất chấp, mặc dù
register==(v) đăng ký, ghi danh
registered==(adj) đã đăng ký, bảo đảm (thư)
regularly==(adv) thường xuyên, đều đặn, theo quy tắc
regulation==(n) quy định, quy tắc, điều lệ; (v) điều khiển, điều tiết
rehearse==(v) diễn tập, tập kịch
reinforce==(v) tăng cường, củng cố
reject==(v) từ chối, bác bỏ
relatively==(adv) hơi, tương đối
relaxation==(n) sự nghỉ ngơi, sự giải trí
release==(v) phát hành, cấp phép
relinquish==(v) từ bỏ, giao, dâng, nộp
rely==(v) tin cậy, dựa vào
remainder==(n) phần còn lại, chỗ còn lại, số dư
remember==(v) nhớ, ghi nhớ, nhớ lại
remind==(v) nhắc nhở, làm nhớ lại
remote==(adj) xa, xa xôi, hẻo lánh
repel==(v) khước từ, cự tuyệt, đẩy lùi
replace==(v) thay thế
represent==(v) tiêu biểu cho, tượng trưng cho, đại diện cho
reputation==(n) danh tiếng, thương hiệu
require==(v) yêu cầu, đòi hỏi
research==(n) sự nghiên cứu
reserve==(n) đặt; giữ trước, để dành
resolve==(v) giải quyết (vấn đề)
resource==(v) tài sản, tài nguyên
respond==(v) trả lời, đáp ứng, phản ứng lại
responsibility==(n) bổn phận, nhiệm vụ, trách nhiệm
restore==(v) phục hồi
restriction==(n) sự hạn chế. sự giới hạn
result==(n) hậu quả, kết quả
retire==(v) về hưu
return==(n) tiền lời; doanh lợi, thu nhập
review==(n) sự phê bình, bài phê bình (cuốn sách, vở kịch); (v) phê bình
revise==(v) duyệt lại, sửa đổi
revolution==(n) cuộc cách mạng, sự xoay vòng
risk==(n) nguy cơ, mối nguy hiểm. rui ro
run==(v) hoạt động
salary==(n) lương tháng
sample==(n) mẫu, (v) lấy mẫu, thử mẫu
satisfy==(v) làm hài lòng
scan==(v) nhìn lướt, quét
schedule==(n) lịch trình làm việc, thời gian biểu; (n) lập thời gian biểu, lên lịch làm việc
scrutinize==(v) nhìn kỹ, xem xét kỹ lưỡng, nghiên cứu cẩn thận
search==(v) tìm kiếm
secure==(v) đạt được, chiếm được, tìm được, đảm bảo
select==(v) chọn
sense==(n) cảm giác, khả năng phán đoán
seperate==(adj) riêng rẽ. tách rời
serious==(adj) nghiêm trọng, trầm trọng
service==(n) dịch vụ; sự phục vụ
session==(n) kỳ họp, phiên họp
set up==(v) sắp xếp, xếp đặt.
settle==(v) xác định (nơi chốn); thanh toán (hoá đơn), trả (tiền)
sharp==(adj) nhọn, sắc, đột ngột, (người) thông minh
ship==(v) chuyển đi, gửi đi
shut down==(v) tắt
signature==(n) chữ ký
significant==(adj) đầy ý nghĩ, quan trọng đáng kể
site==(n) nơi, chỗ; (v) đặt, để
situation==(n) tình thế, trạng thái
skills==(n) sự khéo léo, sự tinh xảo, tay nghệ cao
smooth==(adj) trôi chảy, êm thấm, hoà nhã
software==(n) phầm mềm, chương trình chạy trên máy tính
sold out==(adj) bán hết (vé, hàng)
solve==(v) giải quyết, tháo gỡ (vấn đề)
source==(n) nguồn, nguồn gốc
specialize==(v) chuyên về, chuyên môn hoá
specify==(v) chỉ rõ, định rõ
spectrum==(n) một dãy, một chuỗi
spouse==(n) chồng, vợ
stage==(v) trình diễn
statement==(n) bản kê khai, bản báo cáo tài chính
stationery==(n) đồ dùng văn phòng
stay on top of==(v) cập nhật/ nắm bắt thông tin mới nhất
stock==(n) nguồn hàng, nguồn cung cấp; (v) tích trữ
storage==(n) nơi lưu trữ, kho
strategy==(n) chiến lược
strict==(adj) chính xác, nghiêm ngặt
strong==(adj) mạnh mẽ, kiên cố, vững chắc
subcriber==(v) đặt mua dài hạn; (n) thuê bao, người đặt mua
subject to==(adj) khuất phục, tuân thủ, phụ thuộc
subjective==(adj) chủ quan
submit==(v) nộp, trình
substantial==(adj) giàu có, có tài sản, quan trọng, có giá trị lớn.
substitute==(v) thay thế, thế chỗ
subtract==(v) lấy đi, trừ đi
success==(n) sự thành công, thắng lợi
successive==(adj) kế tiếp, liên tục, lần lượt
sufficient==(adj) đủ
suggest==(v) đề nghị
suitable==(adj) phù hợp, thích ứng
supervisor==(n) người giám sát
supply==(v) cung cấp, đáp ứng nhu cầu; (n) kho dự trữ
system==(n) hệ thống
systematic==(adj) có hệ thống, có phương pháp
take back==(v) nhận lại, rút lại
take out==(v) thu hồi, rút lui
take part in==(v) tham gia, tham dự
target==(n) mục tiêu; (v) đặt mục tiêu
taste==(n) sự nếm (thức ăn), khả năng nhận thức (vị), khiếu thẩm mĩ, khẩu vị
technical==(adj) chuyên môn, kỹ thuật
tedious==(adj) tẻ nhạt, thiếu hấp dẫn
tempt==(v) cám dỗ, quyến rũ
terms==(n) điều kiện, điều khoản
theme==(n) đề tài, chủ đề
thorough==(adj) hoàn toàn, kỹ lưỡng
thrill==(n) sự rùng mình (hoảng sợ), sự rộn ràng (vì vui sướng)
throw out==(v) vứt bỏ
tier==(n) tầng, lớp, bậc
time-consuming==(adj) dài dòng, tốn thời gian
training==(n) sự đào tạo
transaction==(n) công việc kinh doanh, giao dịch
translation==(n) sự chuyển, sự dịch, bản dịch
trend==(n) xu hướng, mốt, cái đang thịnh hành
turnover==(n) sự luân chuyển vốn; số lượng công nhân thay thế (những người thôi việc trong một thời gian nhất định), doanh thu
typical==(adj) tiêu biểu, đặc thù
uniform==(adj) đồng dạng, cùng kiểu
update==(v) cập nhật; (n) thông tin mới nhất
urge==(v) nài nỉ, cố thuyết phục/ thúc giục; (n) sự ham muốn mạnh mẽ
usual==(adj) thường lệ, thường dùng
valid==(adj) có hiệu lực, hợp lệ
value==(n) giá trị, ý nghĩa
vary==(v) thay đổi, biến đổi

verbal==(adj) bằng lời
verify==(v) xác minh, thẩm tra, kiểm lại
vested==(adj) được trao cho, được quyền
volunteer==(n) tình nguyện viên ; (v) xung phong làm
wage==(n) tiền công; lương (trả theo giờ làm việc)
warn==(v) cảnh báo
waste==(v) lãng phí; (n) rác, vật không có giá trị
weakness==(n) nhược điểm
wise==(adj) thông thái, sáng suốt, có kinh nghiệm, hiểu biết nhiều
withhold==(v) kìm lại, giữ lại, giấu
wrinkle==(n) nếp gấp (vải, quần áo)
yield==(n) sản lượng, lợi nhuận; (v) sinh lợi
abolish==cancel; put an end to
absence==the state of being away from a place or person
acclaim==applaud; announce with great approval
accomplished==skilled, proficient
accountable==responsible
acquaint==v. To make familiar or conversant.
acquired==developed or learned; not naturally occurring
acquisition==one company's purchase of the property and obligations of another company
adopt==take up, choose, follow
adversity==a state of misfortune or affliction
advisable==appropriate to do; sensible
affect==influence
affiliate==to become closely associated with
against the law==illegal
aggressive==assertive, vigorously active, quick to attack
alliance==a joining together for some common purpose
alumni==graduates of a school or college
announcement==a formal public statement
anonymous==nameless
antique==Pertaining to ancient times.
apparently==obviously
applaud==to show approval, especially by clapping hands
appropriately==suitable or probable in given circumstances
argument==a statement of the meaning or main point of a literary work
assemble==To bring together into a group; to gather
assert==to declare or affirm solemnly and formally as true
assure==(verb) to give confidence to : encourage.
attentively==with attention or alertness
attire==clothing
attribute==ascribe; explain
auction==the public sale of something to the highest bidder
authentic==genuine
automate==to control something using machines and not people
baggage==a case used to carry belongings when traveling
banquet==a ceremonial dinner party for many people
bargain==something that is sold for less than its usual price or its real value
bid==出價
biography==story of a person's life written by another person
boom==flourish, thrive, prosper
brisk==quick and active; marked by liveliness and vigor
brochure==a booklet or pamphlet that contains descriptive information or advertising
bulk==the property of something that is great in magnitude
by all means==certainly, of course
campaign==a series of operations to accomplish a goal
carrier==運輸工具
cartridge==a case that holds a bullet, primer powder, and gunpowder
clientele==a group of customers or patrons
commission==An amount paid to an employee based on a percentage of the employee's sales
commit==perform an act, usually with a negative connotation
commitment==n. The act or process of entrusting or consigning for safe-keeping.
commodity==anything that is bought or sold
compatible==able to get along or work well together; capable of use with some other model or system
compel==to force or strongly persuade; coerce
compensation==something (such as money) given or received as payment
complaint==a statement that you are unhappy or not satisfied with something
compliance==conforming to a request or demand
complicated==hard to understand; elaborate; complex; intricate
comply==to yield to a request or command
compromise==A settlement in which each side gives up some of its demands in order to reach an agreement.
conclusive==serving to settle an issue; final
condense==to reduce or make more compact
conduct==lead; guide; escort
confidential==communicated in trust; secret; private
conglomerate==Corporation; partnership; firm.
consecutive==following in order
consequence==result
consignment==Goods that are given to a business to sell but for which title to the goods remains with the vendor
consistent==constant; remaining the same
constitution==law determining the fundamental political principles of a government
contemporary==(adj.) belonging to the same period of time as oneself; (n.) a person of the same time
coordinate==to bring together to work smoothly
corporation==body authorized by law to act as a single person and to have rights and duties
corrosion==a state of deterioration in metals caused by oxidation or chemical action
courteous==polite and gracious; considerate toward others; well-mannered
critical==finding fault
curriculum==course of study in a school or college
custody==holding by the police
customarily==usually; by habit or tradition
customs==海關
deadlock==standstill resulting from the opposition of two unrelenting forces; stalemate
dealer==a person or company that buys and sells things for profit
declare==to make known; to state openly
dedicate==to devote to a serious purpose
defective==imperfect or faulty
defy==refuse to obey
demand==the desire, ability, and willingness to buy a product
depart==to leave
depiction==a graphic or vivid verbal description
depression==a period of low economic activity and rising unemployment
devise==think up; invent; plan
directory==a list of names and addresses
disclose==to reveal
discretion==good judgement
dispute==argument
disregard==to ignore
diverse==many and different
do one's utmost==do one's best
domestic==relating to the home or family; relating to one's own country
drastic==strong; violent and severe;
drastically==extremely
duplicate==a copy that corresponds to an original exactly
duty==import tax
dwindle==to lessen, diminish
economize==reduce expenses; be frugal
enactment==the passing of a law by a legislative body
encompass==(v.) to encircle, go or reach around; to enclose; to include with a certain group or class
enforce==to make people obey a rule or law
envision==to picture in the mind; to imagine
evaluation==to consider or study something carefully and decide how good or bad it is
exclusive==private; closed to those not permitted; single or sole
exotic==foreign, unfamiliar
expertise==specialized knowledge (in a particular field); expert skill
expiration==
extremely==to a very high degree
fabric==a material that is woven or knitted, such as cloth
fairly==reasonably, moderately, tolerably, pretty
fascinating==extremely interesting
favorably==showing approval
foster==help develop, help grow
fraud==something intended to deceive
fufill==to complete or accomplish totally
gap==a space or opening between two things
guarantee==ensure
headquarter==n. the center from which orders are given; the main offices of a business or organization
hospitality==friendly welcome and treatment of guests
impeccable==flawless
impede==to obstruct or interfere with; to delay
impend==about to happen
imperative==absolutely necessary
implement==to put into action; execute
implication==the act of suggesting or hinting
improvise==(v.) to compose or perform without preparation; to construct from available materials
in observance of==紀念
incentive==Something that encourages greater action or effort, such as a reward
indication==the act of pointing out or pointing to something
indulge==(v.) to give in to a wish or desire, give oneself up to
infringement==(n) the reduction of someone's rights
infuriate==to make very angry
innovative==introducing something new
inquire==to ask about
inquiry==a request for information
inspection==the act of examining or reviewing
inspiration==a product of your creative thinking and work
installment==buying an item on credit with a monthly plan to pay off the value of the good
instruct==to teach
instruction==the act of teaching or providing knowledge
intensify==To increase; to strengthen or deepen
intention==the aim or objective of a course of action
inventory==the quantity of goods that a firm has on hand
itinerary==route of a traveler's journey
lax==Not strict; careless, loose, slack
legitimate==(adj.) lawful, rightful; reasonable, justifiable
lend==v. to permit someone to use a thing temporarily; to make a loan of money
manuscript==a handwritten or typed piece of writing, such as a book
marginal==insignificant
mastermind==the person who came up with an idea or plan
means==a method, course of action, or instrument by which something can be accomplished
monopoly==Complete control of a product or business by one person or group
mounting==increasing
mutually==in a mutual or shared manner
negotiation==discussion aimed at reaching an agreement
obligation==A legal or moral responsibility or duty
officiate==(v) to perform the duties of an office, to conduct a religious ceremony, to referee
omit==to leave out
on-site==in the physical workplace
ordinance==a law
oversee==supervise
patent==exclusive rights over an invention
permanent==lasting forever
petition==a formal request
precaution==a measure taken in advance to prevent harm
priority==the thing of most importance
processing==involves changing and improving the form of another product
procrastinate==to delay unnecessarily
prohibit==to stop one from doing something; prevent
promising==showing signs of future success
promptly==quickly
proponent==one who argues in favor of; supporter
proposal==A plan or suggestion put forward for consideration or discussion by others
proprietor==owner
prosecute==(v.) to bring before a court of law for trial; to carry out
prospect==that which is expected
proximity==nearness
publicize==to make open to all people; to make widely known; to make public
punctuality==being on time
quote==報價
realistically==Relating to things as they actually are in reality
redeemable==able to be turned in or exchanged for money or products
reflective==illustrating innermost thoughts and emotions
refrain==(v.) - to hold oneself back, forbear
refuse==show unwillingness towards
renovate==to repair, restore to good condition, make new again
reprimand==to show sharp disapproval
resolve==bring to an end; reach a decision
respondent==someone who answers, or responds to, a survey
revision==the act of rewriting something
revolutionary==involving or causing a complete or dramatic change
scrub==to clean something by rubbing it hard with a brush
seasonal==occurring at or dependent on a particular season
severe==very bad or serious
sincerity==the quality of being honest or genuine
smock==a kind of shirt that is worn over clothes to protect them
sophisticated==complex or intricate
spare==kept in reserve especially for emergency use
specifically==for a particular reason, purpose, etc.
specification==A detailed description of the design and materials used to make something.
specify==Identify clearly and definitely
stagnant==motionless; stale; dull
stand over==to watch somebody doing something
stipulation==a demand or condition of an agreement
strew==to scatter
subordinate==lower in rank or importance
subscription==a written agreement to buy and read a magazine or newspaper for a set period of time
subsequent==following in time or order
subsidiary==a company that is completely controlled by another company
substantiate==to verify, confirm
superb==excellent
supervision==the act of managing or directing
tailored==adapted, fitted
take the place of==substitute for, be there instead of
take turns==alternate, do something in turns
terminate==to bring to an end
timely==Well-timed, happening at a suitable time
trespass==entry to another's property without right or permission
undertake==enter into an activity
utilize==make use of
variety==A number of different kinds; assortment
violate==to break, as a law or a promise
voluntarily==by choice or free will; willingly
wane==to decrease gradually
A and B alike==A和B一樣
a majority of==大多數的
abolish==(vt.)廢止,革除,取消
absence==(n.)缺席
abstain==戒除, 避免
abstain from
accommodating==(a.)親切的,樂於助人的
account for==成為...的原因
占(比例)
說明
acne==青春痘, 粉刺
acquaintance==認識的人
acquisition costs==收購成本
address==(v. )處理, 解決, 演說
adequate==(a.)足夠的,充分的;適當的,適合的
adhere==(v.遵守，堅持
adhere to policies/rules/standards)
admonish==告誡
advent==來到,來臨
adverse==(a.)不利的,敵對的,相反的,逆的
advocate==主張, 提倡
aesthetic==(a.)美學的,審美的,有美感
affiliate==n. 附屬機構,分公司
affluent==富裕的
agenda==議程,應辦事項
aisle==走廊,通道,過道
alleviate==(vt.)減輕,使緩和
alma mater==母校
alteration==修改
alumni==校友
amenity==便利設施
animate==(adj.7)有生命的;活潑的;有活力的
anticipate==v.t. 預期; 預料
antique==古董,古物(a.)舊式的,過時的
anxious==(a.)憂慮的,焦急的;渴望的,急要的
appetizer==開胃菜
appraise
performance appraisals==v.評價, 鑑定, 評估
業績評估
apprehensive==(a.擔心的.惴惴不安的
=concerned)
appropriate==(a.)適當的,
v.挪用,撥款
apron==圍裙
archway==拱門
ardently==熱烈地
arguably==可以說是
aspire==v.立志、渴望、追求
associate==同事
(v.)聯想,把...聯想在一起
attendant==服務員
attire==服裝,盛裝(vt.)穿衣,打扮
attribute A to B==把A歸因於B
audit==v.審計
auditorium==n. 禮堂
autograph==v.簽名, 簽署
balcony==陽台
banquet==n.宴會
bargain==討價還價
bazzar==特賣會
be applicable toward==適用於...
be cognizant of==了解
be committed to + Ving==致力於...
be consistent with==與...一致
be contingent on==視...而定
be dedicated to + Ving==專注於, 致力於
be devoted to + Ving==致力於, 專注於
be entitled to==有資格, 有權利
be exempt from==免於...
be instrumental in==在...方面有重要作用
be integral to==不可或缺的
be known to A as B==為A所知的B
be reliant on===be rely on 依賴
be subject to==受...的控制, 容易受到...影響
be superior to==優於...
A is superior to B
A 優於 B
beam==(n)梁, 桁條, (光線的)束, 柱, 電波, 橫梁 ; (v)播送
beneficiary==n.受惠者, 受益人
bewildered==(a.)困惑的
board of directors==董事會
booth==(n.)攤位，棚子，公共電話亭
boulevard==大道
bouquet==花束,一束花
briefcase==公事包
bulletin
bulletin board==公告
公佈欄
burdensome==沈重的，繁重的
by the time==在...之, 到了...的時候
cafeteria==自助餐廳
calendar==n. 日曆
canvas==(n.6)油畫布
capital==資本,資金,資方;首都
carton==硬紙盒,紙板箱
cartridge==墨水匣
printer cartridge
caterer==餐飲業者
chimney==煙囪
civic==(a.)市的,市民的,公民的
clarity==n.清楚,透明
（思想、文體等的）清楚；明晰
collaborate with
collaborate on==和某人合作
在某事物上合作
commemorate==(vt.)紀念
commission==佣金
compel==(vt.)強迫,脅迫,迫使
compelling==(a.)极吸引人的，令人无法抗拒的
compensate A for B==因為B補償A
complimentary==(a.)免費的, 恭維的,贊美的,問候的
comply with==同意,服從,遵守,履行
comprehend==v. 理解
comprehensive==(a.)廣泛的
comprise==(vt.)包括,包含,組成,構成
compromise==(n.)妥協,折衷,折衷案,和解(vi.)妥協處理(vt.)危害
compulsory==adj.必要的；強制的
conceal==(vt.)隱瞞,隱匿,隱蔽,隱藏
conceivable==adj. 可想到的，可相信的，可想像的
condominium==n. 公寓大樓
conducive==a. 有助於...的，有益的
confined==(a.)被限制的,狹窄的
conform==(vt.)使一致,遵守,使順從(vi.)一致,符合,適應環境(a.)一致的,順從的
consensus==共識
consequently==結果, 因此
conserve==保存
consolidate==(vt.)鞏固,使聯合,統一(vi.)鞏固
contamination==污染
contemporary==同時代的人(a.)同時代的,同時,屬於同一時期的
contentment==n.滿意, 知足
contingency plan==應變計畫
contingency==n.突發狀況
contributor==撰稿人
convene==(vt.)集合,召集,召喚(vi.)聚集,集合
convinced==(a.)確信的,深信的
cope==v. 競爭、對付、妥善處理
cordial==(a.)親切的
counterfeit==贗品,偽造品(a.)假冒的,假裝的(vt.)(vi.)仿造,偽裝,假裝
courier==快遞
courtyard==n.庭院
crate==裝貨箱
credential==資格, 証明
crisis==危機
crosswalk==斑馬線
cruise==郵輪
crust==(n.5)麵包皮;派餅皮;硬外皮
cuisine==n. 烹飪；菜餚
culinary==烹飪的
curator==館長
curb==v. 抑制, 控制
currency==n.貨幣
curtail==(v. ) 減少(費用)
decor==裝飾
dedicate==(vt.)奉獻,獻身於,致力於,題獻給
delegate==代表,委員(v.)委派,委託,授權
deliberate==(a.)深思熟慮的,故意的,從容的(vi.)(vt.)仔細考慮
deputy==代理人,代表
dermatologist==皮膚科醫生
designate==(vt.)指定,指派,稱呼
deteriorate==(vt.)(vi.)(使)惡化
diminish==(vt.)(vi.)(使)減少,(使)變小
diminutive==非常小的
disburse==v. 支付, 支出
discreet==(a.)小心的,慎重的
divulge==(v)洩漏、透漏
dock==n. 碼頭 v. 停靠碼頭
doorway==出入口
dough==生麵團
downswing==v. 下跌, 萎縮
draft==草稿,草圖
drill==(vt.)操練,訓練;鑽
drop by==順便拜訪
eloquent==(a.)雄辯的,有口才的,動人的
embassy==大使館
enclosed form==附上的表格
endorse==(v.)背書, 表態支持, 代言
engage==(vt.)從事於;訂婚(vi.)從事於,參加
enlist==(vi.)請求...的幫助, 從軍,贊助
enthusiastic==(a.)熱情的,熱心的,熱烈的
enthusiastically==熱心地, 熱情地, 踴躍地
entitle==(vt.)給...權利;給...題名,給...稱號
entrepreneur==企業家,主辦人
enviable==令人羨慕的
erect==(a.)直立的,豎立的,筆直的(vt.)使豎立,使直立,樹立,建立(vi.)勃起
escort==(vt.)護衛,護送
ethical==倫理的;道德的
evacuate==(vt.)(vi.)疏散,撤出,排泄
evacuation==疏散, 撤離
exaggerate==(vt.)誇張,誇大(vi.)誇張,誇大
exclusively==(ad.)獨占地
exert==(vt.)發揮,運用,施以影響
expedite==(vt.)加快,促進,派出(a.)暢通的,無阻礙的,迅速的,方便的
expire==到期，終止
exposition==博覽會
facilitate==(vt.)幫助,使容易,促進
facilitator==n.促進者,演講者
faculty member==教職員
familiarize==(vt.)使熟悉,使熟知,使通俗化
fatigue==(n.)疲勞
(v.)使疲勞
faucet==水龍頭
feasible==(a.)可行的,行得通的;可能的
fence==籬笆
filing cabinet==檔案櫃
fine==罰款
fireplace==n.壁爐
fleet==n.艦隊
forge==(vi.)鍛造,偽造
forum==論壇
fountain==自動飲水機, 噴泉
fraud
fraudulent==騙子,欺騙,欺詐,詭計
詐欺的
freestyle
butterfly
breaststroke
backstroke==自由式
蝶式
蛙式
仰式
freight==貨運，貨物
furnish A with B==為A提供B
garage==(n)車庫
garment==衣服
gemstone==寶石
genuine==(a.)真正的,名副其實的;真誠的,坦率的
gift certificate==禮券
given that==考慮到
glow==(vi.)發光
n. 光彩
gorilla==大猩猩
grocery==食品,雜貨;食品雜貨店
ground coffee==研磨咖啡
harbor==港,避難所(vt.)庇護,隱藏,藏匿(vi.)入港停泊,躲藏
heritage==n. 世界遺產,
遺產,祖先所留之物,繼承物
hoist==v. 吊高, 升起; n. 起重機
hood==(n.4)兜帽;引擎蓋
hose==水管
hospitable==(a.)好客的,招待周到的
imitate==v. 模仿
immense==(a.)巨大的, 極廣大的,無邊的,非常好的
immerse==(vt.)浸漬,浸泡,使沈浸,使埋頭
impart==(vt.)給予,傳授,告知
imperative==(adj)必要的;極重要的
improvisational==adj.即興的
in light of==根據, 考慮到
in observance of==遵守...; 慶祝...
in recognition of==為了褒獎...
inadvertently==(ad.)不注意地, 粗心地
inaugural==開幕的、就職的
incentive==激勵物;動機(n)
激發的;鼓勵的(adj)
incorporate==合併
incorporated A into B==把A包含在B裡
inferior==(a.)次等的,較低的,下方的,下級的低下的人,次品,下附文字
influx==(v)注入、湧入
infrastructure==基礎建設
ingenious==(a.)靈敏的,精巧的,聰明的
inquiry==詢問,打聽;質詢
insolent==傲慢的；無禮的
institute==學校,協會;講座(vt.)建立,設立;開始
instrumentation==(機器)儀表
intervene==(vi.)介入,干涉
intricate==(a.)復雜的,錯綜的,纏結的,難懂的
intriguing==(a.)吸引人的,有趣的
invoice==發票
itinerary==旅遊行程
junction==(n)交叉路口、連接
lackluster==a.無光澤的;無生氣的
ladder==n.梯子
lamp shade==燈罩
lamppost==路燈
landscape==景觀
lane==通道, 車道
lapse in==在某方面的失誤/過失
leak==v. 滲漏，洩露 n. 漏洞，漏水
lease==(vt.)租
leisurely==(a.)悠閒的 (adv.)悠閒地
lenient==(a.)寬大的,寬容的,慈悲為懷的
literary==文學的
lodge==(v.)租房間給...住,暫住;投宿
look into==調查
look over==檢查, 查看
looming==逼近的
lucrative==(a.)有利益的,獲利的
lumber==木材
luster==(n)光澤、光輝
maintain==(vt.)維修,維持,主張;供養,扶養
markedly==明顯地
market share==市場佔有率
marvelous==不可思議的，非凡的
media coverage==媒體報導
meticulously==非常細心地, 一絲不苟地
metropolitan==大都市的
misplace==a.誤置的,一時找不到的
momentarily==馬上
monument
monumental==紀念碑
紀念性的
morale==士氣,民心
mortgage==抵押借款
mug==馬克杯
multistory==多層的
nail==指甲
notion==`
概念,觀念,想法,打算,主張
oar==槳
obesity==肥胖
obligation==義務,職責
occasion==場合
office supplies
cleaning supplies==辦公用品
清潔用品
on behalf of==代表
orientation==方向, 方針,新生訓練
outgoing==(adj.8)直率的;即將離職的;友善的
outlet==n.暢貨中心；電源插座
outpatient==門診病人
outstanding account==未清帳目
overdue==(a.)過期的,未兌的,遲到的
overturn==推翻
paddle==(vi.)劃槳,戲水,涉水
patent==專利
patient==病人(a.)忍耐的,容忍的,有耐性的
patron==顧客
patronage==贊助
payroll==薪水冊;工資名單
pension==退休金
perceptible==adj.可察覺的, 顯而易見的, 感覺得到的
personnel department==人事部門
pertinent==adj.恰當的；相關的
philanthropic==(a.)慈善的, 博愛的
physician==醫師
pile==堆疊
pillar==柱子,支柱,台柱,紀念柱,棟梁
plagiarize==(vt.)(vi.)剽竊,抄襲
plate==盤子
platform==平臺,月臺;政綱,黨綱
portfolio==n.投資組合（如債券和股票）、作品集
portrait==肖像, 畫像
possession==(n.) (不可數)擁有，(複數)所有物、財產
premiere==首映
premise==n. 前提, 假設；經營場地
(vt.)提論,預述,假定(vi.)作出前提
prescription==處方,藥方
present==a.當前的, 現在的
v. 出示, 表達, 呈顯
n. 禮物
preside==(vi.)主持, 主導
press conference==記者會
press release==新聞稿
press==新聞報道
prevalent==(a.)普遍的,流行的
prick==(n.5)刺;扎;刺傷;悔恨
(v)刺
primetime==黃金時段
privilege==特權,基本人權
privileged==(a.)有特權的,有特別恩典的
proficient==(a.)精通的,熟練的
prominent==(a.)卓越的,顯著的,突出的
promptly==(ad.)立即地,迅速地
prospect==景色,希望,展望(vt.)勘探,尋找(vi.)勘探,有前途
provided==假如, 倘若
province==(n)省;州
provisional==臨時的；暫時的
publicist==公關
pull up==停車,停下來
questionnaire==n. 問卷, 調查表
quote==引用, 報價
rack==架子
raffle==n. 抽獎（活動）
railing==欄杆
ramp==(n)斜面、坡道
rebate==(n.)現金回扣(vt.)減少,打折扣(vi.)給回扣,打折扣
reception==接待,招待會
recreate==v.娛樂
reform==(n.)改革,改良
refrain==v. 抑制，避免
refreshment==點心
refuel==加油
refurbish==(vt.)再磨光,翻新
refute==(vt.)駁倒,反駁
rehearsal==彩排
reimbursement==核銷
relief effort==救災行動
remains==n. 遺跡
remark==評論,致詞
renewal==n.(合約)更新, 續約
resent==(vt.)憤恨,憎惡,怨恨
resign==v. 辭職
resort==(n.)渡假勝地、渡假村
(v.)求助,訴諸,採取,憑借常去,常去的地方,勝地
restless==(a.)焦躁的, 不安的
restore==(vt.)恢復,使回復;歸還,交還;修復,重建
retain==保留
reunite==(v.)重聚,重新結合,統一
revolting==(a.)討厭的, 背叛的, 叛亂的
rim==邊框, 輪緣
roll out==展開,碾平;滔滔不絕地說出
round-trip==adj.來回的
row==划船
rug==毯子,地毯,旅行毯
sanctuary==保護區, 避難所,聖壇
sanitize==vt.殺菌, 消毒
savor==品嚐, 享受
savory==可口的, 美味的
scatter==到處散亂
secretary==秘書
see out==堅持到結束
堅持做完
sequel==n.續集
session==會議,學期
set forth==提出
settle==vi. 解决；定居；下陷
vt. 解决；安排；使...定居
severance==n 資遣費,資遣,隔離
share==(n.)股份
shelter==庇護所
skeptical==(a.)懷疑的
slump==經濟上的衰退
solicit==v.請求、懇求、徵求
solitary==獨居者(a.)單獨的, 孤獨的,獨居的
soothe==v.舒緩 減輕 緩和
sophisticated==adj 世故的 老練的 精密複雜的
spacious==adj.(空間)寬敞的
span over==橫跨
squirt==v.噴出
stagnant==(a.)停滯的,不景氣的,蕭條的,汙濁的
state-of-the-art==最先進的
stationery==文具
statue==n.雕像, 蠟像
steep==[形容詞] 陡峭的; [動詞] 浸泡;浸透
sterilize==vt.殺菌, 消毒
stipulate==(vt.)規定
stir==(v.4)攪拌,攪動
stool==凳子
strenuous==(a.)費力的, 吃力的
strike==敲打,罷工
stringently==ad.嚴格地，嚴重地
subordinate==(n.)下屬
(a.)下屬的, 次要的
subsidy==(n)津貼、補貼=allowance
substandard==未達標準的
superficial==(a.)表面的, 膚淺的
suspect==(n.) 嫌犯, (v)懷疑
tableware==餐具
tackle==滑車(vt.)固定,處理,抓住(vi.)扭倒
take over==接管
take time off (to do)==請假(做...)
tardiness==n.遲到
tariff==關稅
tax break==減稅措施
That's the plan==正是如此
toll==通行費
tow==(v.)拖,拉;牽引
traffic congestion==交通雍塞
trailer==拖曳者,拖車,追蹤者
tray==托盤
trial==審判,試驗(a.)嘗試的,試驗性的
trolley==手推車
turn down==拒絕
turnout==出席者
twofold==兩倍的
unanimous==(a.)意見一致的,無異議的
unattended luggage==無人看守的行李
underprivileged==弱勢的
undertaking==事業, 工作
unmatched==adj. 無可匹敵的、獨一無二的
unsound==不穩固的，不安全的
utensil==n. 廚具；用具
vessel==n.船艦；血管
viable==(a.)可行的
vibrant==充滿活力的
viewership==收視率
vigilant==(a.)警醒的,警戒著的,警惕的
voucher==禮券
waive==(vt.)免除,放棄,
warranty==保固
water cooler==飲水機
wharf==(n)碼頭
dock at wharf
wheel==(n.) 輪子,(vt.)旋轉,拉或推有輪子的東西
wholesale==批發的
windshield==擋風玻璃
without further ado==不多說了
(ad.)立即,乾脆
work shift
night shift==輪值時間
夜班
